//MAP CONVERTED BY dmm2tgm.py THIS HEADER COMMENT PREVENTS RECONVERSION, DO NOT REMOVE
"eH" = (
/obj/structure/table/reinforced,
/obj/effect/turf_decal/tile/brown/opposingcorners{
	dir = 1
	},
/obj/item/reagent_containers/cup/glass/bottle/lizardwine,
/turf/open/floor/iron/smooth,
/area/centcom/tdome/arena/actual)
"fu" = (
/obj/machinery/conveyor/auto{
	dir = 8;
	use_power = 0
	},
/obj/effect/spawner/random/trash/garbage,
/obj/structure/plasticflaps,
/turf/open/floor/plating,
/area/centcom/tdome/arena/actual)
"gh" = (
/obj/effect/turf_decal/tile/brown/opposingcorners,
/obj/effect/spawner/random/trash/graffiti,
/obj/effect/decal/cleanable/dirt/dust,
/turf/open/floor/iron/smooth,
/area/centcom/tdome/arena/actual)
"gM" = (
/obj/effect/turf_decal/tile/brown/half,
/obj/effect/decal/cleanable/dirt/dust,
/turf/open/floor/iron/smooth_edge,
/area/centcom/tdome/arena/actual)
"hb" = (
/obj/machinery/conveyor/auto{
	dir = 4;
	use_power = 0
	},
/obj/structure/plasticflaps,
/turf/open/floor/plating,
/area/centcom/tdome/arena/actual)
"hH" = (
/obj/effect/turf_decal/tile/brown/opposingcorners,
/obj/effect/spawner/random/trash/graffiti,
/obj/machinery/light/floor/has_bulb,
/turf/open/floor/iron/smooth,
/area/centcom/tdome/arena/actual)
"hW" = (
/obj/machinery/conveyor/auto{
	dir = 8;
	use_power = 0
	},
/obj/structure/plasticflaps,
/turf/open/floor/plating,
/area/centcom/tdome/arena/actual)
"kf" = (
/obj/effect/turf_decal/tile/brown/opposingcorners{
	dir = 1
	},
/obj/effect/spawner/random/trash/graffiti,
/turf/open/floor/iron/smooth,
/area/centcom/tdome/arena/actual)
"kt" = (
/obj/structure/disposalpipe/segment,
/turf/open/floor/catwalk_floor/iron_smooth,
/area/centcom/tdome/arena/actual)
"nK" = (
/turf/closed/indestructible/fakeglass,
/area/centcom/tdome/arena/actual)
"nU" = (
/obj/machinery/conveyor/auto{
	dir = 4;
	use_power = 0
	},
/turf/open/floor/plating,
/area/centcom/tdome/arena/actual)
"oD" = (
/obj/machinery/conveyor/auto{
	dir = 4;
	use_power = 0
	},
/obj/effect/spawner/random/trash/garbage,
/obj/structure/plasticflaps,
/turf/open/floor/plating,
/area/centcom/tdome/arena/actual)
"qw" = (
/obj/machinery/conveyor/auto{
	dir = 1;
	use_power = 0
	},
/obj/structure/disposalpipe/segment,
/turf/open/floor/plating,
/area/centcom/tdome/arena/actual)
"rT" = (
/obj/effect/turf_decal/tile/brown/half{
	dir = 1
	},
/obj/effect/decal/cleanable/dirt/dust,
/obj/structure/table/reinforced,
/turf/open/floor/iron/smooth_edge{
	dir = 1
	},
/area/centcom/tdome/arena/actual)
"sM" = (
/obj/effect/turf_decal/tile/brown/opposingcorners,
/obj/machinery/light/floor/has_bulb,
/turf/open/floor/iron/smooth,
/area/centcom/tdome/arena/actual)
"tE" = (
/obj/machinery/conveyor/auto{
	dir = 1;
	use_power = 0
	},
/obj/structure/disposalpipe/segment,
/obj/effect/spawner/random/trash/garbage,
/turf/open/floor/plating,
/area/centcom/tdome/arena/actual)
"tL" = (
/obj/effect/turf_decal/tile/brown/half,
/obj/effect/decal/cleanable/dirt/dust,
/obj/structure/table/reinforced,
/turf/open/floor/iron/smooth_edge,
/area/centcom/tdome/arena/actual)
"tQ" = (
/obj/structure/disposalpipe/segment,
/obj/effect/landmark/duel_arena/dueler_spawn/two,
/turf/open/floor/catwalk_floor/iron_smooth,
/area/centcom/tdome/arena/actual)
"uD" = (
/obj/effect/turf_decal/tile/brown/half,
/obj/structure/steam_vent,
/turf/open/floor/iron/smooth_edge,
/area/centcom/tdome/arena/actual)
"uW" = (
/obj/effect/turf_decal/tile/brown/half,
/obj/structure/table/reinforced,
/turf/open/floor/iron/smooth_edge,
/area/centcom/tdome/arena/actual)
"vY" = (
/obj/structure/disposaloutlet,
/obj/structure/disposalpipe/trunk,
/obj/structure/plasticflaps,
/turf/open/floor/iron/dark/textured_large,
/area/centcom/tdome/arena/actual)
"wv" = (
/obj/effect/turf_decal/tile/brown/opposingcorners{
	dir = 1
	},
/obj/machinery/light/floor/has_bulb,
/turf/open/floor/iron/smooth,
/area/centcom/tdome/arena/actual)
"wX" = (
/obj/effect/turf_decal/tile/brown/opposingcorners{
	dir = 1
	},
/obj/effect/decal/cleanable/wrapping,
/obj/machinery/light/floor/has_bulb,
/turf/open/floor/iron/smooth,
/area/centcom/tdome/arena/actual)
"xG" = (
/obj/effect/turf_decal/tile/brown/half{
	dir = 1
	},
/obj/structure/steam_vent,
/turf/open/floor/iron/smooth_edge{
	dir = 1
	},
/area/centcom/tdome/arena/actual)
"xK" = (
/obj/structure/disposalpipe/segment,
/obj/structure/cable/layer1,
/obj/structure/cable,
/obj/structure/cable/layer3,
/turf/open/floor/catwalk_floor/iron_smooth,
/area/centcom/tdome/arena/actual)
"yn" = (
/obj/machinery/conveyor/auto{
	use_power = 0
	},
/obj/structure/disposalpipe/segment,
/turf/open/floor/plating,
/area/centcom/tdome/arena/actual)
"yM" = (
/obj/machinery/disposal/delivery_chute,
/obj/structure/disposalpipe/trunk,
/obj/structure/plasticflaps,
/turf/open/floor/iron/dark/textured_large,
/area/centcom/tdome/arena/actual)
"zF" = (
/obj/structure/disposaloutlet{
	dir = 1
	},
/obj/structure/disposalpipe/trunk{
	dir = 1
	},
/obj/structure/plasticflaps,
/turf/open/floor/iron/dark/textured_large,
/area/centcom/tdome/arena/actual)
"zG" = (
/obj/machinery/conveyor/auto{
	dir = 8;
	use_power = 0
	},
/turf/open/floor/plating,
/area/centcom/tdome/arena/actual)
"Cr" = (
/obj/machinery/disposal/delivery_chute{
	dir = 1
	},
/obj/structure/disposalpipe/trunk{
	dir = 1
	},
/obj/structure/plasticflaps,
/turf/open/floor/iron/dark/textured_large,
/area/centcom/tdome/arena/actual)
"Dt" = (
/turf/closed/indestructible/reinforced,
/area/centcom/tdome/arena/actual)
"DQ" = (
/obj/effect/turf_decal/tile/brown/opposingcorners{
	dir = 1
	},
/obj/effect/decal/cleanable/dirt/dust,
/obj/machinery/light/floor/has_bulb,
/turf/open/floor/iron/smooth,
/area/centcom/tdome/arena/actual)
"Gk" = (
/obj/effect/turf_decal/tile/brown/opposingcorners,
/turf/open/floor/iron/smooth,
/area/centcom/tdome/arena/actual)
"Iq" = (
/obj/machinery/conveyor/auto{
	dir = 8;
	use_power = 0
	},
/obj/item/grenade/smokebomb,
/turf/open/floor/plating,
/area/centcom/tdome/arena/actual)
"Jn" = (
/obj/structure/disposalpipe/segment,
/obj/effect/landmark/duel_arena/dueler_spawn/one,
/turf/open/floor/catwalk_floor/iron_smooth,
/area/centcom/tdome/arena/actual)
"JZ" = (
/obj/machinery/conveyor/auto{
	dir = 4;
	use_power = 0
	},
/obj/structure/disposalpipe/segment,
/obj/effect/spawner/random/trash/garbage,
/turf/open/floor/plating,
/area/centcom/tdome/arena/actual)
"LT" = (
/obj/machinery/conveyor/auto{
	dir = 4;
	use_power = 0
	},
/obj/item/grenade/smokebomb,
/turf/open/floor/plating,
/area/centcom/tdome/arena/actual)
"MS" = (
/obj/effect/turf_decal/tile/brown/opposingcorners,
/obj/effect/decal/cleanable/dirt/dust,
/turf/open/floor/iron/smooth,
/area/centcom/tdome/arena/actual)
"MY" = (
/obj/machinery/conveyor/auto{
	dir = 8;
	use_power = 0
	},
/obj/structure/disposalpipe/segment,
/obj/effect/spawner/random/trash/garbage,
/turf/open/floor/plating,
/area/centcom/tdome/arena/actual)
"Nd" = (
/obj/structure/table/reinforced,
/obj/effect/turf_decal/tile/brown/opposingcorners,
/obj/item/reagent_containers/cup/glass/bottle/lizardwine,
/obj/effect/decal/cleanable/dirt/dust,
/turf/open/floor/iron/smooth,
/area/centcom/tdome/arena/actual)
"NR" = (
/obj/effect/turf_decal/tile/brown/half,
/turf/open/floor/iron/smooth_edge,
/area/centcom/tdome/arena/actual)
"PA" = (
/obj/effect/turf_decal/tile/brown/opposingcorners,
/obj/effect/decal/cleanable/wrapping,
/turf/open/floor/iron/smooth,
/area/centcom/tdome/arena/actual)
"PS" = (
/obj/effect/turf_decal/tile/brown/half{
	dir = 1
	},
/obj/effect/decal/cleanable/dirt/dust,
/obj/structure/steam_vent,
/turf/open/floor/iron/smooth_edge{
	dir = 1
	},
/area/centcom/tdome/arena/actual)
"PW" = (
/obj/effect/turf_decal/tile/brown/opposingcorners{
	dir = 1
	},
/obj/effect/decal/cleanable/dirt/dust,
/turf/open/floor/iron/smooth,
/area/centcom/tdome/arena/actual)
"Qk" = (
/obj/machinery/conveyor/auto{
	dir = 4;
	use_power = 0
	},
/obj/structure/disposalpipe/segment,
/turf/open/floor/plating,
/area/centcom/tdome/arena/actual)
"Ri" = (
/obj/machinery/conveyor/auto{
	use_power = 0
	},
/obj/structure/disposalpipe/segment,
/obj/effect/spawner/random/trash/garbage,
/turf/open/floor/plating,
/area/centcom/tdome/arena/actual)
"UL" = (
/obj/effect/turf_decal/tile/brown/half{
	dir = 1
	},
/turf/open/floor/iron/smooth_edge{
	dir = 1
	},
/area/centcom/tdome/arena/actual)
"Vz" = (
/obj/machinery/camera/motion/thunderdome{
	pixel_x = 10
	},
/turf/closed/indestructible/fakeglass,
/area/centcom/tdome/arena/actual)
"Wg" = (
/obj/structure/table/reinforced,
/obj/effect/turf_decal/tile/brown/opposingcorners,
/obj/item/reagent_containers/cup/glass/bottle/hooch,
/turf/open/floor/iron/smooth,
/area/centcom/tdome/arena/actual)
"Xf" = (
/obj/machinery/conveyor/auto{
	dir = 8;
	use_power = 0
	},
/obj/structure/disposalpipe/segment,
/turf/open/floor/plating,
/area/centcom/tdome/arena/actual)
"Xk" = (
/obj/effect/turf_decal/tile/brown/opposingcorners,
/obj/effect/decal/cleanable/dirt/dust,
/obj/machinery/light/floor/has_bulb,
/turf/open/floor/iron/smooth,
/area/centcom/tdome/arena/actual)
"XS" = (
/obj/effect/turf_decal/tile/brown/half{
	dir = 1
	},
/obj/effect/spawner/random/trash/graffiti,
/turf/open/floor/iron/smooth_edge{
	dir = 1
	},
/area/centcom/tdome/arena/actual)
"ZM" = (
/obj/structure/table/reinforced,
/obj/effect/turf_decal/tile/brown/opposingcorners{
	dir = 1
	},
/obj/item/reagent_containers/cup/glass/bottle/hooch,
/turf/open/floor/iron/smooth,
/area/centcom/tdome/arena/actual)

(1,1,1) = {"
Dt
UL
gh
Xk
Gk
MS
sM
MS
NR
Dt
"}
(2,1,1) = {"
vY
yn
nU
yn
yn
yn
Ri
yn
yn
Cr
"}
(3,1,1) = {"
nK
nK
oD
nK
nK
nK
nK
hW
nK
nK
"}
(4,1,1) = {"
yM
qw
nU
kt
kt
Jn
kt
zG
tE
zF
"}
(5,1,1) = {"
nK
PS
nU
Xk
Wg
Nd
Xk
zG
uD
nK
"}
(6,1,1) = {"
vY
Ri
Qk
xK
xK
xK
xK
Xf
yn
Cr
"}
(7,1,1) = {"
nK
rT
nU
Xk
PA
MS
hH
zG
tL
nK
"}
(8,1,1) = {"
yM
qw
Qk
kt
kt
kt
kt
MY
qw
zF
"}
(9,1,1) = {"
nK
XS
LT
nK
nK
Vz
nK
Iq
gM
nK
"}
(10,1,1) = {"
vY
yn
JZ
kt
kt
kt
kt
Xf
Ri
Cr
"}
(11,1,1) = {"
nK
rT
nU
DQ
kf
PW
DQ
zG
uW
nK
"}
(12,1,1) = {"
yM
tE
Qk
xK
xK
xK
xK
Xf
qw
zF
"}
(13,1,1) = {"
nK
xG
nU
wX
eH
ZM
wv
zG
uD
nK
"}
(14,1,1) = {"
vY
yn
nU
kt
tQ
kt
kt
zG
yn
Cr
"}
(15,1,1) = {"
nK
nK
hb
nK
nK
nK
nK
fu
nK
nK
"}
(16,1,1) = {"
yM
qw
qw
tE
qw
qw
qw
zG
qw
zF
"}
(17,1,1) = {"
Dt
UL
PW
wv
PW
kf
wv
PW
gM
Dt
"}
