//MAP CONVERTED BY dmm2tgm.py THIS HEADER COMMENT PREVENTS RECONVERSION, DO NOT REMOVE
"am" = (
/obj/effect/spawner/structure/window/reinforced/plasma,
/turf/open/floor/plating,
/area/station/engineering/main)
"aW" = (
/obj/effect/spawner/structure/window/reinforced,
/turf/open/floor/plating,
/area/station/engineering/main)
"bj" = (
/obj/effect/turf_decal/tile/yellow/fourcorners,
/obj/machinery/light/directional/south,
/turf/open/floor/iron,
/area/station/engineering/main)
"bn" = (
/obj/effect/turf_decal/stripes/line{
	dir = 9
	},
/obj/structure/cable/layer1,
/turf/open/floor/plating/airless,
/area/space/nearstation)
"bv" = (
/obj/structure/particle_accelerator/particle_emitter/center,
/turf/open/floor/plating,
/area/station/engineering/main)
"cp" = (
/obj/machinery/camera/directional/north{
	c_tag = "Engineering - Station Particle Accelerator, Northwest";
	name = "engineering camera"
	},
/turf/open/floor/plating/airless,
/area/space/nearstation)
"cA" = (
/obj/structure/grille,
/turf/open/floor/plating/airless,
/area/space/nearstation)
"dc" = (
/obj/effect/turf_decal/stripes/line{
	dir = 1
	},
/turf/open/floor/plating/airless,
/area/space/nearstation)
"dd" = (
/obj/machinery/light/directional/south,
/turf/open/floor/plating/airless,
/area/space/nearstation)
"di" = (
/obj/structure/cable/layer1,
/turf/open/floor/plating/airless,
/area/space/nearstation)
"dZ" = (
/obj/effect/turf_decal/stripes/line{
	dir = 6
	},
/turf/open/floor/plating/airless,
/area/space/nearstation)
"fX" = (
/obj/effect/turf_decal/stripes/line,
/obj/effect/turf_decal/stripes/line{
	dir = 1
	},
/obj/machinery/atmospherics/pipe/layer_manifold/scrubbers/hidden,
/obj/structure/cable,
/obj/machinery/door/airlock/external{
	name = "Engine Access Airlock"
	},
/obj/effect/mapping_helpers/airlock/access/all/engineering/general,
/obj/effect/mapping_helpers/airlock/cyclelink_helper{
	dir = 1
	},
/turf/open/floor/plating,
/area/station/engineering/main)
"ge" = (
/obj/effect/turf_decal/tile/yellow/fourcorners,
/obj/machinery/atmospherics/components/unary/vent_pump/on/layer4,
/turf/open/floor/iron,
/area/station/engineering/main)
"go" = (
/obj/effect/turf_decal/stripes/line{
	dir = 8
	},
/obj/effect/turf_decal/stripes/line{
	dir = 4
	},
/obj/machinery/atmospherics/pipe/smart/manifold4w/scrubbers/hidden/layer2,
/obj/machinery/atmospherics/pipe/smart/manifold4w/supply/hidden/layer4,
/obj/structure/cable,
/obj/machinery/door/poddoor/shutters/preopen{
	id = "particle_accelerator";
	name = "Particle Accelerator Shutters";
	dir = 4
	},
/turf/open/floor/iron/dark/textured,
/area/station/engineering/main)
"gu" = (
/turf/open/floor/plating,
/area/station/engineering/main)
"gV" = (
/obj/effect/turf_decal/stripes/box,
/obj/structure/cable,
/obj/machinery/power/emitter/welded{
	dir = 4
	},
/turf/open/floor/plating/airless,
/area/space/nearstation)
"hl" = (
/obj/machinery/atmospherics/pipe/smart/manifold4w/scrubbers/hidden/layer2,
/obj/machinery/atmospherics/pipe/smart/manifold4w/supply/hidden/layer4,
/obj/structure/cable,
/turf/open/floor/iron/dark,
/area/station/engineering/main)
"hq" = (
/obj/machinery/light/directional/south,
/turf/open/floor/iron/dark,
/area/station/engineering/main)
"hr" = (
/obj/effect/turf_decal/delivery/red,
/obj/structure/cable,
/turf/open/floor/plating/airless,
/area/space/nearstation)
"hA" = (
/obj/effect/turf_decal/stripes/line{
	dir = 9
	},
/turf/open/floor/plating/airless,
/area/space/nearstation)
"hE" = (
/obj/machinery/atmospherics/components/unary/vent_scrubber/on/layer2{
	dir = 1
	},
/turf/open/floor/iron/dark,
/area/station/engineering/main)
"hJ" = (
/obj/effect/turf_decal/stripes/corner,
/turf/open/floor/plating/airless,
/area/space/nearstation)
"jB" = (
/obj/effect/turf_decal/stripes/line{
	dir = 6
	},
/obj/structure/window/reinforced/plasma/spawner/directional/east,
/turf/open/floor/plating/airless,
/area/space/nearstation)
"jV" = (
/obj/machinery/atmospherics/pipe/smart/manifold4w/scrubbers/hidden/layer2,
/obj/machinery/atmospherics/pipe/smart/manifold4w/supply/hidden/layer4,
/obj/structure/cable,
/obj/structure/particle_accelerator/end_cap,
/turf/open/floor/plating,
/area/station/engineering/main)
"kk" = (
/obj/machinery/power/energy_accumulator/tesla_coil,
/turf/open/floor/iron/dark/airless,
/area/station/engineering/main)
"kr" = (
/obj/effect/turf_decal/tile/yellow/fourcorners,
/obj/machinery/atmospherics/pipe/smart/manifold4w/scrubbers/hidden/layer2,
/obj/machinery/atmospherics/pipe/smart/manifold4w/supply/hidden/layer4,
/obj/structure/cable,
/turf/open/floor/iron,
/area/station/engineering/main)
"ks" = (
/turf/closed/wall/r_wall,
/area/space/nearstation)
"kI" = (
/obj/effect/turf_decal/stripes/line{
	dir = 5
	},
/obj/structure/cable/layer1,
/turf/open/floor/plating/airless,
/area/space/nearstation)
"kV" = (
/obj/item/stack/cable_coil,
/turf/open/floor/plating,
/area/station/engineering/main)
"lC" = (
/obj/effect/turf_decal/stripes/line,
/obj/effect/turf_decal/stripes/line{
	dir = 1
	},
/obj/machinery/door/poddoor/shutters/preopen{
	id = "particle_accelerator";
	name = "Particle Accelerator Shutters"
	},
/turf/open/floor/iron/dark/textured,
/area/station/engineering/main)
"mE" = (
/obj/effect/turf_decal/tile/yellow/fourcorners,
/obj/machinery/atmospherics/components/unary/vent_scrubber/on/layer2,
/turf/open/floor/iron,
/area/station/engineering/main)
"mJ" = (
/obj/effect/turf_decal/tile/yellow/fourcorners,
/obj/structure/closet/radiation,
/turf/open/floor/iron,
/area/station/engineering/main)
"mK" = (
/obj/structure/particle_accelerator/power_box,
/turf/open/floor/plating,
/area/station/engineering/main)
"mS" = (
/obj/effect/turf_decal/stripes/line{
	dir = 4
	},
/obj/structure/window/reinforced/plasma/spawner/directional/east,
/obj/structure/cable,
/obj/structure/cable/layer1,
/turf/open/floor/plating/airless,
/area/space/nearstation)
"na" = (
/obj/effect/turf_decal/stripes/line{
	dir = 1
	},
/obj/machinery/light/small/directional/north,
/obj/machinery/button/door/directional/north{
	id = "particle_accelerator";
	name = "Particle Accelerator Shutters Control";
	req_access = list("engineering")
	},
/obj/machinery/camera/directional/north{
	c_tag = "Engineering - Particle Accelerator Chamber";
	name = "engineering camera"
	},
/turf/open/floor/plating,
/area/station/engineering/main)
"nd" = (
/obj/structure/cable/multilayer/connected,
/turf/open/floor/plating/airless,
/area/space/nearstation)
"nl" = (
/obj/effect/turf_decal/delivery/red,
/obj/structure/cable,
/obj/structure/cable/layer1,
/turf/open/floor/plating/airless,
/area/space/nearstation)
"nn" = (
/obj/effect/turf_decal/box/red,
/turf/open/floor/plating/airless,
/area/space/nearstation)
"nq" = (
/obj/structure/cable,
/obj/machinery/door/firedoor,
/obj/effect/spawner/structure/window/reinforced/plasma,
/turf/open/floor/plating,
/area/station/engineering/main)
"nN" = (
/obj/machinery/atmospherics/pipe/smart/simple/orange/visible{
	dir = 4
	},
/obj/machinery/door/firedoor,
/obj/effect/spawner/structure/window/reinforced/plasma,
/turf/open/floor/plating,
/area/station/engineering/main)
"oN" = (
/turf/open/floor/iron/dark,
/area/station/engineering/main)
"pQ" = (
/obj/effect/turf_decal/stripes/line,
/obj/effect/turf_decal/stripes/line{
	dir = 1
	},
/obj/structure/sign/warning/vacuum/external/directional/south,
/turf/open/floor/plating,
/area/station/engineering/main)
"pW" = (
/obj/effect/turf_decal/stripes/line,
/turf/open/floor/plating,
/area/station/engineering/main)
"qo" = (
/obj/effect/turf_decal/tile/yellow/fourcorners,
/obj/machinery/atmospherics/pipe/smart/manifold4w/scrubbers/hidden/layer2,
/obj/machinery/atmospherics/pipe/smart/manifold4w/supply/hidden/layer4,
/turf/open/floor/iron,
/area/station/engineering/main)
"qp" = (
/obj/structure/particle_accelerator/particle_emitter/right,
/turf/open/floor/plating,
/area/station/engineering/main)
"sM" = (
/obj/effect/turf_decal/stripes/line{
	dir = 8
	},
/obj/effect/turf_decal/stripes/line{
	dir = 4
	},
/obj/machinery/door/poddoor{
	id = "engine_storage";
	name = "Engine Storage"
	},
/turf/open/floor/plating/airless,
/area/station/engineering/main)
"sN" = (
/obj/effect/turf_decal/stripes/line{
	dir = 6
	},
/obj/structure/cable,
/turf/open/floor/plating,
/area/station/engineering/main)
"sX" = (
/obj/structure/closet/crate,
/obj/item/stack/sheet/iron/fifty,
/obj/item/stack/rods/fifty,
/turf/open/floor/plating/airless,
/area/space/nearstation)
"ti" = (
/obj/effect/turf_decal/stripes/end{
	dir = 4
	},
/obj/machinery/atmospherics/pipe/smart/manifold4w/scrubbers/hidden/layer2,
/obj/machinery/atmospherics/components/binary/dp_vent_pump/high_volume/on/layer4,
/obj/machinery/button/door/directional/east{
	id = "engine_storage";
	name = "Engine Storage Control";
	req_access = list("engineering")
	},
/turf/open/floor/plating,
/area/station/engineering/main)
"tq" = (
/obj/effect/turf_decal/stripes/line,
/obj/effect/turf_decal/stripes/line{
	dir = 1
	},
/obj/machinery/atmospherics/pipe/layer_manifold/scrubbers/hidden,
/obj/machinery/door/airlock/external{
	name = "Engine Access Airlock"
	},
/obj/effect/mapping_helpers/airlock/access/all/engineering/general,
/obj/effect/mapping_helpers/airlock/cyclelink_helper{
	dir = 1
	},
/turf/open/floor/plating,
/area/station/engineering/main)
"tJ" = (
/obj/effect/turf_decal/stripes/line,
/obj/structure/cable,
/turf/open/floor/plating,
/area/station/engineering/main)
"tQ" = (
/obj/effect/turf_decal/stripes/line,
/obj/effect/turf_decal/stripes/line{
	dir = 1
	},
/obj/machinery/atmospherics/pipe/smart/manifold4w/scrubbers/hidden/layer2,
/obj/machinery/atmospherics/pipe/smart/manifold4w/supply/hidden/layer4,
/obj/structure/cable,
/obj/machinery/door/airlock/external{
	name = "Engine Access Airlock"
	},
/obj/effect/mapping_helpers/airlock/access/all/engineering/general,
/obj/effect/mapping_helpers/airlock/cyclelink_helper,
/turf/open/floor/plating,
/area/station/engineering/main)
"ug" = (
/obj/machinery/light/directional/north,
/turf/open/floor/iron/dark,
/area/station/engineering/main)
"vF" = (
/obj/structure/chair/stool/directional/north,
/turf/open/floor/plating,
/area/station/engineering/main)
"vZ" = (
/obj/machinery/power/emitter,
/turf/open/floor/iron/dark/airless,
/area/station/engineering/main)
"wp" = (
/obj/machinery/power/rad_collector,
/turf/open/floor/iron/dark/airless,
/area/station/engineering/main)
"wD" = (
/obj/effect/turf_decal/stripes/line,
/obj/effect/turf_decal/stripes/line{
	dir = 1
	},
/obj/machinery/atmospherics/pipe/smart/manifold4w/scrubbers/hidden/layer2,
/obj/machinery/atmospherics/pipe/smart/manifold4w/supply/hidden/layer4,
/obj/structure/cable,
/obj/machinery/door/firedoor,
/obj/machinery/door/airlock/engineering/glass,
/obj/effect/mapping_helpers/airlock/access/all/engineering/general,
/turf/open/floor/iron/dark/textured,
/area/station/engineering/main)
"wK" = (
/obj/effect/turf_decal/stripes/line{
	dir = 4
	},
/obj/machinery/light/directional/east,
/obj/structure/cable,
/turf/open/floor/plating,
/area/station/engineering/main)
"wX" = (
/obj/structure/lattice,
/turf/open/space/basic,
/area/space/nearstation)
"xj" = (
/obj/effect/turf_decal/stripes/line{
	dir = 10
	},
/turf/open/floor/plating,
/area/station/engineering/main)
"xK" = (
/obj/effect/turf_decal/stripes/line,
/obj/item/stack/cable_coil,
/turf/open/floor/plating/airless,
/area/space/nearstation)
"xL" = (
/obj/effect/turf_decal/stripes/line{
	dir = 4
	},
/obj/structure/window/reinforced/plasma/spawner/directional/east,
/obj/structure/cable,
/turf/open/floor/plating/airless,
/area/space/nearstation)
"xR" = (
/obj/effect/turf_decal/stripes/line{
	dir = 4
	},
/obj/structure/cable,
/turf/open/floor/plating,
/area/station/engineering/main)
"yD" = (
/obj/effect/turf_decal/stripes/line{
	dir = 9
	},
/obj/structure/window/reinforced/plasma/spawner/directional/west,
/turf/open/floor/plating/airless,
/area/space/nearstation)
"zk" = (
/obj/effect/turf_decal/stripes/line{
	dir = 4
	},
/obj/effect/turf_decal/stripes/line{
	dir = 8
	},
/obj/machinery/atmospherics/pipe/smart/manifold4w/scrubbers/hidden/layer2,
/obj/machinery/atmospherics/pipe/smart/manifold4w/supply/hidden/layer4,
/obj/structure/cable,
/obj/machinery/door/firedoor,
/obj/machinery/door/airlock/engineering/glass{
	name = "Engine Room"
	},
/obj/effect/mapping_helpers/airlock/access/all/engineering/general,
/turf/open/floor/iron/dark/textured,
/area/station/engineering/main)
"zF" = (
/obj/machinery/door/airlock/engineering/glass,
/obj/machinery/atmospherics/pipe/smart/manifold4w/scrubbers/hidden/layer2,
/obj/machinery/atmospherics/pipe/smart/manifold4w/supply/hidden/layer4,
/obj/structure/cable,
/obj/effect/mapping_helpers/airlock/access/all/engineering/general,
/obj/machinery/door/firedoor,
/obj/effect/turf_decal/stripes/line{
	dir = 4
	},
/obj/effect/turf_decal/stripes/line{
	dir = 8
	},
/turf/open/floor/iron/dark/textured,
/area/station/engineering/main)
"zN" = (
/obj/effect/turf_decal/stripes/line{
	dir = 10
	},
/turf/open/floor/plating/airless,
/area/space/nearstation)
"zZ" = (
/obj/effect/turf_decal/stripes/line{
	dir = 5
	},
/obj/structure/window/reinforced/plasma/spawner/directional/east,
/turf/open/floor/plating/airless,
/area/space/nearstation)
"AW" = (
/obj/structure/lattice/catwalk,
/obj/machinery/light/directional/west,
/obj/structure/sign/warning/directional/west,
/obj/structure/cable,
/turf/open/space/basic,
/area/space/nearstation)
"Cd" = (
/obj/effect/turf_decal/stripes/line{
	dir = 8
	},
/obj/structure/window/reinforced/plasma/spawner/directional/west,
/obj/structure/cable,
/turf/open/floor/plating/airless,
/area/space/nearstation)
"Cq" = (
/obj/machinery/door/firedoor,
/obj/effect/spawner/structure/window/reinforced/plasma,
/turf/open/floor/plating,
/area/station/engineering/main)
"Cs" = (
/obj/effect/turf_decal/stripes/line{
	dir = 5
	},
/turf/open/floor/plating/airless,
/area/space/nearstation)
"CY" = (
/obj/machinery/atmospherics/components/unary/vent_pump/on/layer4{
	dir = 1
	},
/turf/open/floor/iron/dark,
/area/station/engineering/main)
"Da" = (
/obj/structure/cable,
/obj/structure/cable/layer1,
/turf/open/floor/plating/airless,
/area/space/nearstation)
"Ds" = (
/obj/effect/turf_decal/bot_red,
/turf/open/floor/plating/airless,
/area/space/nearstation)
"DP" = (
/obj/effect/turf_decal/stripes/line,
/obj/effect/turf_decal/stripes/line{
	dir = 1
	},
/obj/machinery/atmospherics/pipe/smart/manifold4w/scrubbers/hidden/layer2,
/obj/machinery/atmospherics/pipe/smart/manifold4w/supply/hidden/layer4,
/obj/machinery/door/airlock/external{
	name = "Engine Access Airlock"
	},
/obj/effect/mapping_helpers/airlock/access/all/engineering/general,
/obj/effect/mapping_helpers/airlock/cyclelink_helper,
/turf/open/floor/plating,
/area/station/engineering/main)
"El" = (
/obj/effect/turf_decal/stripes/end{
	dir = 8
	},
/obj/machinery/light/small/directional/south,
/obj/structure/closet/emcloset/anchored,
/turf/open/floor/plating,
/area/station/engineering/main)
"EW" = (
/obj/structure/lattice/catwalk,
/obj/structure/cable,
/turf/open/space/basic,
/area/space/nearstation)
"Fj" = (
/obj/effect/turf_decal/stripes/line{
	dir = 9
	},
/turf/open/floor/plating,
/area/station/engineering/main)
"Fz" = (
/obj/effect/turf_decal/tile/yellow/fourcorners,
/turf/open/floor/iron,
/area/station/engineering/main)
"FH" = (
/obj/effect/turf_decal/bot_red,
/obj/machinery/field/generator,
/obj/structure/cable,
/turf/open/floor/plating/airless,
/area/space/nearstation)
"FJ" = (
/obj/machinery/light/small/directional/west,
/obj/machinery/power/energy_accumulator/tesla_coil,
/turf/open/floor/iron/dark/airless,
/area/station/engineering/main)
"FP" = (
/obj/effect/turf_decal/stripes/line{
	dir = 8
	},
/turf/open/floor/plating/airless,
/area/space/nearstation)
"Gv" = (
/obj/structure/lattice,
/obj/item/stack/cable_coil,
/turf/open/space/basic,
/area/space/nearstation)
"GK" = (
/obj/effect/turf_decal/stripes/box,
/obj/structure/cable,
/turf/open/floor/plating/airless,
/area/space/nearstation)
"GW" = (
/turf/template_noop,
/area/template_noop)
"Hj" = (
/obj/effect/turf_decal/tile/yellow/fourcorners,
/obj/structure/table,
/obj/item/storage/toolbox/electrical,
/turf/open/floor/iron,
/area/station/engineering/main)
"Hs" = (
/obj/effect/turf_decal/stripes/box,
/obj/machinery/light/directional/north,
/obj/structure/sign/warning/electric_shock/directional/north,
/obj/structure/cable,
/obj/machinery/power/energy_accumulator/grounding_rod/anchored,
/turf/open/floor/plating/airless,
/area/space/nearstation)
"HB" = (
/obj/structure/sign/warning/directional,
/turf/closed/wall/r_wall,
/area/station/engineering/main)
"HF" = (
/obj/effect/turf_decal/stripes/line{
	dir = 4
	},
/turf/open/floor/plating/airless,
/area/space/nearstation)
"HP" = (
/obj/effect/turf_decal/stripes/box,
/turf/open/floor/plating/airless,
/area/space/nearstation)
"HX" = (
/obj/effect/turf_decal/stripes/line{
	dir = 8
	},
/obj/effect/turf_decal/stripes/line{
	dir = 4
	},
/obj/machinery/atmospherics/pipe/smart/manifold4w/scrubbers/hidden/layer2,
/obj/machinery/atmospherics/pipe/smart/manifold4w/supply/hidden/layer4,
/obj/structure/cable,
/obj/machinery/door/poddoor/shutters/preopen{
	id = "particle_accelerator";
	name = "Particle Accelerator Shutters";
	dir = 8
	},
/turf/open/floor/iron/dark/textured,
/area/station/engineering/main)
"JO" = (
/obj/effect/turf_decal/stripes/line{
	dir = 4
	},
/obj/structure/cable/layer1,
/turf/open/floor/plating/airless,
/area/space/nearstation)
"JY" = (
/obj/effect/turf_decal/stripes/corner{
	dir = 8
	},
/turf/open/floor/plating/airless,
/area/space/nearstation)
"Kd" = (
/obj/effect/turf_decal/stripes/line{
	dir = 8
	},
/obj/machinery/button/door/directional/west{
	id = "particle_accelerator";
	name = "Particle Accelerator Shutters Control";
	req_access = list("engineering")
	},
/turf/open/floor/plating,
/area/station/engineering/main)
"Li" = (
/obj/machinery/field/generator,
/turf/open/floor/iron/dark/airless,
/area/station/engineering/main)
"Lo" = (
/obj/effect/turf_decal/stripes/end{
	dir = 8
	},
/obj/machinery/atmospherics/pipe/smart/manifold4w/scrubbers/hidden/layer2,
/obj/machinery/atmospherics/components/binary/dp_vent_pump/high_volume/on/layer4,
/obj/structure/cable,
/turf/open/floor/plating,
/area/station/engineering/main)
"Lp" = (
/obj/effect/turf_decal/bot_red,
/obj/machinery/field/generator,
/turf/open/floor/plating/airless,
/area/space/nearstation)
"Lt" = (
/obj/effect/turf_decal/tile/yellow/fourcorners,
/obj/structure/table,
/obj/item/crowbar/red,
/turf/open/floor/iron,
/area/station/engineering/main)
"Mz" = (
/obj/machinery/camera/directional/north{
	c_tag = "Engineering - Station Particle Accelerator, Northeast";
	name = "engineering camera"
	},
/turf/open/floor/plating/airless,
/area/space/nearstation)
"MB" = (
/obj/effect/turf_decal/stripes/line{
	dir = 4
	},
/obj/machinery/atmospherics/pipe/smart/manifold4w/scrubbers/hidden/layer2,
/obj/machinery/atmospherics/pipe/smart/manifold4w/supply/hidden/layer4,
/obj/structure/cable,
/turf/open/floor/plating,
/area/station/engineering/main)
"MS" = (
/obj/effect/turf_decal/stripes/line{
	dir = 4
	},
/obj/machinery/button/door/directional/east{
	id = "particle_accelerator";
	name = "Particle Accelerator Shutters Control";
	req_access = list("engineering")
	},
/obj/structure/cable,
/obj/item/weldingtool,
/turf/open/floor/plating,
/area/station/engineering/main)
"Nd" = (
/obj/effect/turf_decal/stripes/line{
	dir = 5
	},
/turf/open/floor/plating,
/area/station/engineering/main)
"NU" = (
/obj/effect/turf_decal/stripes/line,
/turf/open/floor/plating/airless,
/area/space/nearstation)
"NW" = (
/obj/effect/turf_decal/stripes/line{
	dir = 1
	},
/turf/open/floor/plating,
/area/station/engineering/main)
"Or" = (
/obj/machinery/light/small/directional/south,
/obj/machinery/power/rad_collector,
/turf/open/floor/iron/dark/airless,
/area/station/engineering/main)
"Pl" = (
/obj/effect/turf_decal/stripes/line{
	dir = 8
	},
/obj/machinery/atmospherics/pipe/smart/manifold4w/scrubbers/hidden/layer2,
/obj/machinery/atmospherics/pipe/smart/manifold4w/supply/hidden/layer4,
/obj/structure/cable,
/turf/open/floor/plating,
/area/station/engineering/main)
"Px" = (
/obj/effect/turf_decal/tile/yellow/fourcorners,
/obj/structure/sign/warning/directional/south,
/obj/structure/table,
/obj/item/clothing/suit/utility/radiation,
/obj/item/clothing/head/utility/radiation,
/obj/item/clothing/glasses/meson,
/obj/item/geiger_counter,
/turf/open/floor/iron,
/area/station/engineering/main)
"PG" = (
/turf/closed/wall/r_wall,
/area/station/engineering/main)
"PI" = (
/obj/effect/turf_decal/stripes/line{
	dir = 8
	},
/obj/structure/window/reinforced/plasma/spawner/directional/west,
/obj/structure/cable,
/obj/structure/cable/layer1,
/turf/open/floor/plating/airless,
/area/space/nearstation)
"QL" = (
/obj/effect/turf_decal/stripes/corner{
	dir = 1
	},
/turf/open/floor/plating/airless,
/area/space/nearstation)
"QT" = (
/obj/machinery/atmospherics/pipe/smart/manifold4w/scrubbers/hidden/layer2,
/obj/machinery/atmospherics/pipe/smart/manifold4w/supply/hidden/layer4,
/obj/structure/cable,
/turf/open/floor/plating,
/area/station/engineering/main)
"Rw" = (
/obj/effect/turf_decal/tile/yellow/fourcorners,
/obj/structure/table,
/obj/item/storage/toolbox/mechanical,
/obj/item/folder/yellow,
/turf/open/floor/iron,
/area/station/engineering/main)
"RH" = (
/obj/machinery/camera/directional/south{
	c_tag = "Engineering - Station Particle Accelerator, Southeast";
	name = "engineering camera"
	},
/turf/open/floor/plating/airless,
/area/space/nearstation)
"RP" = (
/obj/machinery/camera/directional/south{
	c_tag = "Engineering - Station Particle Accelerator, Southwest";
	name = "engineering camera"
	},
/turf/open/floor/plating/airless,
/area/space/nearstation)
"SB" = (
/obj/effect/turf_decal/tile/yellow/fourcorners,
/obj/machinery/light/directional/south,
/obj/machinery/atmospherics/components/unary/portables_connector/visible{
	dir = 4
	},
/turf/open/floor/iron,
/area/station/engineering/main)
"Ux" = (
/obj/effect/turf_decal/stripes/corner{
	dir = 4
	},
/turf/open/floor/plating/airless,
/area/space/nearstation)
"UL" = (
/obj/structure/particle_accelerator/fuel_chamber,
/turf/open/floor/plating,
/area/station/engineering/main)
"Va" = (
/obj/machinery/power/energy_accumulator/grounding_rod,
/turf/open/floor/iron/dark/airless,
/area/station/engineering/main)
"Vh" = (
/obj/structure/particle_accelerator/particle_emitter/left,
/turf/open/floor/plating,
/area/station/engineering/main)
"VS" = (
/obj/structure/cable,
/turf/open/floor/plating/airless,
/area/space/nearstation)
"WJ" = (
/obj/effect/turf_decal/stripes/line{
	dir = 8
	},
/obj/machinery/light/directional/west,
/turf/open/floor/plating,
/area/station/engineering/main)
"WK" = (
/obj/structure/lattice/catwalk,
/obj/machinery/light/directional/east,
/obj/structure/sign/warning/directional/east,
/obj/structure/cable,
/turf/open/space/basic,
/area/space/nearstation)
"WZ" = (
/obj/effect/turf_decal/stripes/end{
	dir = 4
	},
/obj/machinery/light/small/directional/south,
/obj/structure/closet/emcloset/anchored,
/turf/open/floor/plating,
/area/station/engineering/main)
"Xr" = (
/obj/machinery/particle_accelerator/control_box,
/obj/structure/cable,
/turf/open/floor/plating,
/area/station/engineering/main)
"XX" = (
/obj/effect/turf_decal/stripes/line{
	dir = 8
	},
/obj/structure/cable/layer1,
/turf/open/floor/plating/airless,
/area/space/nearstation)
"Yz" = (
/obj/effect/turf_decal/delivery/red,
/turf/open/floor/plating/airless,
/area/space/nearstation)
"YE" = (
/obj/effect/turf_decal/bot_red,
/obj/structure/cable/multilayer/connected,
/turf/open/floor/plating/airless,
/area/space/nearstation)
"YF" = (
/obj/structure/closet/crate,
/obj/item/stack/sheet/iron/fifty,
/obj/item/stack/sheet/glass/fifty,
/turf/open/floor/plating/airless,
/area/space/nearstation)
"YW" = (
/obj/effect/turf_decal/stripes/line,
/obj/structure/cable,
/turf/open/floor/plating/airless,
/area/space/nearstation)
"Zm" = (
/obj/effect/turf_decal/stripes/box,
/obj/structure/cable,
/obj/machinery/power/emitter/welded{
	dir = 8
	},
/turf/open/floor/plating/airless,
/area/space/nearstation)
"Zp" = (
/turf/open/floor/plating/airless,
/area/space/nearstation)
"ZA" = (
/obj/effect/turf_decal/stripes/line{
	dir = 10
	},
/obj/structure/window/reinforced/plasma/spawner/directional/west,
/turf/open/floor/plating/airless,
/area/space/nearstation)
"ZH" = (
/obj/effect/turf_decal/stripes/line{
	dir = 8
	},
/turf/open/floor/plating,
/area/station/engineering/main)
"ZW" = (
/obj/effect/turf_decal/stripes/line,
/obj/structure/cable/layer1,
/turf/open/floor/plating/airless,
/area/space/nearstation)

(1,1,1) = {"
PG
oN
oN
oN
PG
GW
GW
GW
wX
GW
GW
wX
GW
GW
wX
GW
GW
GW
cA
cA
cA
GW
GW
GW
GW
GW
"}
(2,1,1) = {"
wD
hl
hl
hq
PG
GW
GW
GW
wX
GW
wX
GW
wX
GW
wX
GW
wX
GW
cA
ks
cA
GW
GW
GW
GW
GW
"}
(3,1,1) = {"
PG
oN
hl
CY
aW
GW
GW
wX
wX
wX
wX
Zp
wX
wX
Zp
Zp
wX
wX
cA
ks
cA
GW
GW
GW
GW
GW
"}
(4,1,1) = {"
PG
oN
hl
oN
PG
GW
GW
GW
wX
Zp
Zp
Zp
Zp
Zp
Zp
Zp
wX
GW
cA
ks
cA
GW
GW
GW
GW
GW
"}
(5,1,1) = {"
PG
ug
hl
oN
aW
GW
GW
wX
Zp
Zp
YF
Zp
Zp
Zp
Zp
Zp
wX
wX
cA
ks
cA
GW
GW
GW
GW
GW
"}
(6,1,1) = {"
PG
oN
hl
oN
PG
GW
GW
wX
Zp
Zp
Zp
Zp
Zp
Zp
sX
Zp
wX
GW
cA
ks
cA
GW
GW
GW
GW
GW
"}
(7,1,1) = {"
PG
PG
hl
hE
aW
GW
GW
wX
wX
wX
Zp
Zp
Zp
Zp
Zp
wX
wX
wX
cA
ks
cA
GW
cA
cA
GW
GW
"}
(8,1,1) = {"
GW
PG
hl
hq
PG
GW
GW
wX
wX
Zp
Zp
Zp
Zp
Zp
wX
GW
wX
GW
cA
ks
cA
wX
ks
cA
cA
GW
"}
(9,1,1) = {"
GW
PG
hl
oN
PG
GW
GW
wX
wX
wX
Zp
Zp
wX
wX
wX
wX
wX
wX
cA
cA
cA
wX
ks
ks
cA
GW
"}
(10,1,1) = {"
GW
PG
zF
Cq
PG
GW
GW
wX
wX
GW
wX
GW
wX
GW
wX
GW
wX
GW
wX
wX
wX
GW
GW
wX
GW
GW
"}
(11,1,1) = {"
Fz
Fz
kr
bj
PG
PG
PG
PG
PG
am
am
am
PG
PG
PG
PG
PG
PG
PG
PG
PG
HB
wX
cA
cA
cA
"}
(12,1,1) = {"
Fz
mE
kr
kr
tQ
Lo
fX
VS
nd
di
di
hJ
gV
EW
EW
AW
EW
EW
gV
Ux
wX
PG
GW
cA
ks
cA
"}
(13,1,1) = {"
Fz
Fz
kr
Fz
PG
pQ
PG
cp
Zp
Zp
di
ZW
nl
bn
XX
XX
FP
zN
Yz
dc
RP
PG
wX
cA
ks
cA
"}
(14,1,1) = {"
Lt
Hj
kr
Px
PG
WZ
PG
Hs
nd
di
di
xK
hr
zZ
xL
mS
xL
jB
Yz
dc
Zp
PG
GW
cA
ks
cA
"}
(15,1,1) = {"
PG
PG
HX
PG
PG
Cq
Cq
Cq
Zp
di
Zp
YW
FH
wX
GW
YE
GW
wX
Lp
dc
dd
PG
wX
cA
ks
cA
"}
(16,1,1) = {"
PG
Fj
Pl
Kd
WJ
ZH
xj
Cq
Da
Da
VS
YW
wX
wX
wX
wX
wX
wX
wX
dc
Zp
PG
GW
cA
ks
cA
"}
(17,1,1) = {"
lC
NW
QT
Xr
vF
Vh
pW
Cq
Da
Zp
Zp
NU
GW
wX
hA
FP
zN
wX
GW
dc
Zp
am
wX
cA
ks
cA
"}
(18,1,1) = {"
PG
na
jV
UL
mK
bv
tJ
nq
Da
Zp
HP
NU
Ds
wX
dc
nn
NU
wX
Ds
dc
HP
am
GW
cA
ks
cA
"}
(19,1,1) = {"
lC
NW
QT
gu
kV
qp
tJ
Cq
Da
Zp
Zp
NU
GW
wX
Cs
HF
dZ
wX
GW
dc
Zp
am
wX
cA
ks
cA
"}
(20,1,1) = {"
PG
Nd
MB
MS
wK
xR
sN
Cq
Da
Da
VS
YW
wX
wX
wX
wX
wX
wX
wX
dc
Zp
PG
GW
cA
ks
cA
"}
(21,1,1) = {"
PG
PG
go
PG
PG
Cq
Cq
Cq
Zp
di
Zp
YW
FH
Gv
GW
YE
GW
wX
Lp
dc
dd
PG
wX
cA
ks
cA
"}
(22,1,1) = {"
mJ
Rw
kr
Px
PG
El
PG
Hs
nd
di
di
NU
hr
yD
Cd
PI
Cd
ZA
Yz
dc
Zp
PG
GW
cA
ks
cA
"}
(23,1,1) = {"
Fz
Fz
kr
Fz
PG
pQ
PG
Mz
Zp
Zp
di
ZW
nl
kI
JO
JO
HF
dZ
Yz
dc
RH
PG
wX
cA
ks
cA
"}
(24,1,1) = {"
Fz
ge
kr
qo
DP
ti
tq
Zp
Zp
Zp
Zp
JY
GK
EW
EW
WK
EW
EW
Zm
QL
wX
PG
GW
cA
ks
cA
"}
(25,1,1) = {"
Fz
Fz
kr
SB
PG
PG
PG
PG
sM
sM
am
am
PG
PG
PG
PG
PG
PG
PG
PG
PG
HB
wX
cA
cA
cA
"}
(26,1,1) = {"
GW
PG
zk
nN
PG
PG
kk
FJ
vZ
Li
Li
wp
wp
PG
GW
GW
wX
GW
wX
GW
GW
GW
GW
wX
GW
GW
"}
(27,1,1) = {"
GW
GW
GW
GW
GW
Cq
kk
kk
Va
Va
Li
wp
Or
PG
wX
wX
wX
wX
wX
wX
wX
wX
wX
wX
wX
wX
"}
(28,1,1) = {"
GW
GW
GW
GW
GW
PG
kk
kk
Va
Va
Li
wp
wp
PG
GW
GW
wX
GW
wX
ks
cA
GW
GW
GW
GW
GW
"}
(29,1,1) = {"
GW
GW
GW
GW
GW
PG
PG
PG
PG
PG
am
am
am
PG
wX
wX
wX
wX
wX
ks
cA
GW
GW
GW
GW
GW
"}
