//MAP CONVERTED BY dmm2tgm.py THIS HEADER COMMENT PREVENTS RECONVERSION, DO NOT REMOVE
"a" = (
/turf/open/floor/wood/large,
/area/station/maintenance/aft/upper)
"f" = (
/obj/machinery/atmospherics/components/unary/vent_scrubber/on/layer2,
/mob/living/basic/isaac,
/turf/open/floor/wood/large,
/area/station/maintenance/aft/upper)
"p" = (
/obj/machinery/light/warm/directional/south,
/obj/machinery/atmospherics/pipe/smart/manifold4w/scrubbers/hidden/layer2,
/turf/open/floor/wood/large,
/area/station/maintenance/aft/upper)
"q" = (
/obj/machinery/atmospherics/pipe/smart/manifold4w/supply/hidden/layer4,
/turf/open/floor/wood/large,
/area/station/maintenance/aft/upper)
"w" = (
/obj/machinery/atmospherics/components/unary/vent_pump/on/layer4,
/turf/open/floor/wood/large,
/area/station/maintenance/aft/upper)
"F" = (
/obj/machinery/atmospherics/pipe/smart/manifold4w/scrubbers/hidden/layer2,
/turf/open/floor/wood/large,
/area/station/maintenance/aft/upper)
"U" = (
/obj/machinery/atmospherics/pipe/smart/manifold4w/scrubbers/hidden/layer2,
/obj/machinery/atmospherics/pipe/smart/manifold4w/supply/hidden/layer4,
/obj/modular_map_connector,
/obj/effect/decal/cleanable/blood,
/turf/open/floor/wood/large,
/area/station/maintenance/aft/upper)
"X" = (
/obj/item/structure/fluff/item_altar,
/turf/open/floor/wood/large,
/area/station/maintenance/aft/upper)

(1,1,1) = {"
f
F
p
"}
(2,1,1) = {"
a
a
U
"}
(3,1,1) = {"
a
X
q
"}
(4,1,1) = {"
w
q
q
"}
