//MAP CONVERTED BY dmm2tgm.py THIS HEADER COMMENT PREVENTS RECONVERSION, DO NOT REMOVE
"a" = (
/turf/open/floor/fakebasalt,
/area/station/maintenance/aft/upper)
"b" = (
/obj/machinery/atmospherics/pipe/smart/manifold4w/supply/hidden/layer4,
/mob/living/basic/mining/goldgrub,
/turf/open/floor/fakebasalt,
/area/station/maintenance/aft/upper)
"f" = (
/obj/structure/flora/ash/seraka,
/turf/open/floor/fakebasalt,
/area/station/maintenance/aft/upper)
"i" = (
/obj/machinery/atmospherics/components/unary/vent_pump/on/layer4,
/mob/living/basic/mining/goldgrub/baby,
/turf/open/floor/fakebasalt,
/area/station/maintenance/aft/upper)
"s" = (
/obj/machinery/atmospherics/pipe/smart/manifold4w/supply/hidden/layer4,
/obj/structure/flora/ash/fireblossom,
/turf/open/floor/fakebasalt,
/area/station/maintenance/aft/upper)
"z" = (
/obj/machinery/atmospherics/pipe/smart/manifold4w/scrubbers/hidden/layer2,
/obj/structure/flora/rock,
/turf/open/floor/fakebasalt,
/area/station/maintenance/aft/upper)
"K" = (
/obj/machinery/atmospherics/pipe/smart/manifold4w/supply/hidden/layer4,
/obj/structure/flora/rock,
/turf/open/floor/fakebasalt,
/area/station/maintenance/aft/upper)
"L" = (
/obj/machinery/light/warm/directional/south,
/obj/machinery/atmospherics/pipe/smart/manifold4w/scrubbers/hidden/layer2,
/obj/structure/flora/ash/cacti,
/turf/open/floor/fakebasalt,
/area/station/maintenance/aft/upper)
"N" = (
/obj/machinery/atmospherics/pipe/smart/manifold4w/scrubbers/hidden/layer2,
/obj/machinery/atmospherics/pipe/smart/manifold4w/supply/hidden/layer4,
/obj/modular_map_connector,
/turf/open/floor/fakebasalt,
/area/station/maintenance/aft/upper)
"W" = (
/obj/machinery/atmospherics/components/unary/vent_scrubber/on/layer2,
/mob/living/basic/mining/goldgrub,
/turf/open/floor/fakebasalt,
/area/station/maintenance/aft/upper)

(1,1,1) = {"
W
z
L
"}
(2,1,1) = {"
f
a
N
"}
(3,1,1) = {"
a
a
K
"}
(4,1,1) = {"
i
s
b
"}
