//MAP CONVERTED BY dmm2tgm.py THIS HEADER COMMENT PREVENTS RECONVERSION, DO NOT REMOVE
"a" = (
/obj/machinery/atmospherics/pipe/smart/manifold4w/supply/hidden/layer4,
/obj/effect/turf_decal/siding/wideplating/dark/corner{
	dir = 1
	},
/turf/open/floor/carpet/donk,
/area/station/maintenance/aft/upper)
"i" = (
/mob/living/basic/chicken/clown,
/turf/open/ballpit,
/area/station/maintenance/aft/upper)
"r" = (
/obj/machinery/atmospherics/components/unary/vent_pump/on/layer4,
/mob/living/basic/chicken/clown,
/obj/effect/turf_decal/siding/thinplating/dark{
	dir = 8
	},
/turf/open/floor/carpet/donk,
/area/station/maintenance/aft/upper)
"u" = (
/obj/machinery/light/warm/directional/south,
/obj/machinery/atmospherics/pipe/smart/manifold4w/scrubbers/hidden/layer2,
/mob/living/basic/chicken/clown,
/obj/effect/turf_decal/siding/wideplating/dark/corner{
	dir = 4
	},
/turf/open/floor/carpet/donk,
/area/station/maintenance/aft/upper)
"z" = (
/obj/machinery/atmospherics/components/unary/vent_scrubber/on/layer2,
/obj/effect/turf_decal/siding/thinplating/dark{
	dir = 4
	},
/turf/open/floor/carpet/donk,
/area/station/maintenance/aft/upper)
"F" = (
/obj/machinery/atmospherics/pipe/smart/manifold4w/supply/hidden/layer4,
/obj/effect/turf_decal/siding/thinplating/dark{
	dir = 1
	},
/turf/open/floor/carpet/donk,
/area/station/maintenance/aft/upper)
"G" = (
/turf/open/ballpit,
/area/station/maintenance/aft/upper)
"Q" = (
/obj/machinery/atmospherics/pipe/smart/manifold4w/scrubbers/hidden/layer2,
/obj/machinery/atmospherics/pipe/smart/manifold4w/supply/hidden/layer4,
/obj/modular_map_connector,
/obj/effect/turf_decal/siding/thinplating/dark{
	dir = 1
	},
/turf/open/floor/carpet/donk,
/area/station/maintenance/aft/upper)
"W" = (
/obj/machinery/atmospherics/pipe/smart/manifold4w/scrubbers/hidden/layer2,
/obj/effect/turf_decal/siding/thinplating/dark{
	dir = 4
	},
/turf/open/floor/carpet/donk,
/area/station/maintenance/aft/upper)
"Z" = (
/obj/machinery/atmospherics/pipe/smart/manifold4w/supply/hidden/layer4,
/obj/effect/turf_decal/siding/thinplating/dark{
	dir = 8
	},
/turf/open/floor/carpet/donk,
/area/station/maintenance/aft/upper)

(1,1,1) = {"
z
W
u
"}
(2,1,1) = {"
G
i
Q
"}
(3,1,1) = {"
G
G
F
"}
(4,1,1) = {"
r
Z
a
"}
