//MAP CONVERTED BY dmm2tgm.py THIS HEADER COMMENT PREVENTS RECONVERSION, DO NOT REMOVE
"a" = (
/obj/machinery/atmospherics/pipe/smart/manifold4w/supply/hidden/layer4,
/obj/effect/overlay/water,
/mob/living/basic/aquatic/fish,
/turf/open/misc/ashplanet/rocky,
/area/station/maintenance/aft/upper)
"b" = (
/obj/effect/overlay/water,
/turf/open/misc/ashplanet/wateryrock{
	slowdown = 0
	},
/area/station/maintenance/aft/upper)
"j" = (
/obj/effect/overlay/water,
/mob/living/basic/aquatic/fish/cod,
/turf/open/misc/ashplanet/rocky,
/area/station/maintenance/aft/upper)
"l" = (
/obj/effect/overlay/water,
/mob/living/basic/pet/blahaj,
/turf/open/misc/ashplanet/rocky,
/area/station/maintenance/aft/upper)
"m" = (
/obj/machinery/light/warm/directional/south,
/obj/machinery/atmospherics/pipe/smart/manifold4w/scrubbers/hidden/layer2,
/obj/effect/overlay/water,
/obj/structure/flora/ocean/glowweed,
/turf/open/misc/ashplanet/rocky,
/area/station/maintenance/aft/upper)
"t" = (
/obj/machinery/atmospherics/components/unary/vent_scrubber/on/layer2,
/obj/effect/overlay/water,
/obj/structure/flora/bush/stalky/style_2,
/turf/open/misc/ashplanet/wateryrock{
	slowdown = 0
	},
/area/station/maintenance/aft/upper)
"u" = (
/obj/machinery/atmospherics/components/unary/vent_pump/on/layer4,
/obj/effect/overlay/water,
/obj/structure/flora/ocean/coral,
/turf/open/misc/ashplanet/rocky,
/area/station/maintenance/aft/upper)
"v" = (
/obj/machinery/atmospherics/pipe/smart/manifold4w/scrubbers/hidden/layer2,
/obj/machinery/atmospherics/pipe/smart/manifold4w/supply/hidden/layer4,
/obj/modular_map_connector,
/obj/effect/overlay/water,
/turf/open/misc/ashplanet/rocky,
/area/station/maintenance/aft/upper)
"E" = (
/obj/machinery/atmospherics/pipe/smart/manifold4w/scrubbers/hidden/layer2,
/obj/effect/overlay/water,
/turf/open/misc/ashplanet/wateryrock{
	slowdown = 0
	},
/area/station/maintenance/aft/upper)
"I" = (
/obj/machinery/atmospherics/pipe/smart/manifold4w/supply/hidden/layer4,
/obj/effect/overlay/water,
/turf/open/misc/ashplanet/rocky,
/area/station/maintenance/aft/upper)
"R" = (
/obj/effect/overlay/water,
/obj/structure/flora/ocean/longseaweed,
/turf/open/misc/ashplanet/wateryrock{
	slowdown = 0
	},
/area/station/maintenance/aft/upper)

(1,1,1) = {"
t
E
m
"}
(2,1,1) = {"
b
l
v
"}
(3,1,1) = {"
j
R
I
"}
(4,1,1) = {"
u
I
a
"}
