//MAP CONVERTED BY dmm2tgm.py THIS HEADER COMMENT PREVENTS RECONVERSION, DO NOT REMOVE
"a" = (
/turf/open/floor/fakeice/slippery,
/area/station/maintenance/aft/upper)
"d" = (
/obj/machinery/atmospherics/pipe/smart/manifold4w/supply/hidden/layer4,
/obj/structure/flora/grass/brown,
/turf/open/floor/fake_snow/safe,
/area/station/maintenance/aft/upper)
"l" = (
/obj/machinery/light/warm/directional/south,
/obj/machinery/atmospherics/pipe/smart/manifold4w/scrubbers/hidden/layer2,
/obj/structure/flora/grass/both,
/turf/open/floor/fake_snow/safe,
/area/station/maintenance/aft/upper)
"p" = (
/obj/machinery/atmospherics/components/unary/vent_scrubber/on/layer2,
/turf/open/floor/fake_snow/safe,
/area/station/maintenance/aft/upper)
"x" = (
/obj/machinery/atmospherics/pipe/smart/manifold4w/supply/hidden/layer4,
/obj/structure/statue/snow/snowman,
/turf/open/floor/fake_snow/safe,
/area/station/maintenance/aft/upper)
"y" = (
/obj/machinery/atmospherics/pipe/smart/manifold4w/supply/hidden/layer4,
/turf/open/floor/fakeice/slippery,
/area/station/maintenance/aft/upper)
"D" = (
/mob/living/basic/pet/cirno,
/turf/open/floor/fakeice/slippery,
/area/station/maintenance/aft/upper)
"G" = (
/obj/machinery/atmospherics/pipe/smart/manifold4w/scrubbers/hidden/layer2,
/obj/machinery/atmospherics/pipe/smart/manifold4w/supply/hidden/layer4,
/obj/modular_map_connector,
/turf/open/floor/fake_snow/safe,
/area/station/maintenance/aft/upper)
"I" = (
/obj/structure/flora/grass/brown/style_random,
/turf/open/floor/fake_snow/safe,
/area/station/maintenance/aft/upper)
"V" = (
/obj/machinery/atmospherics/components/unary/vent_pump/on/layer4,
/obj/structure/flora/grass/both,
/turf/open/floor/fake_snow/safe,
/area/station/maintenance/aft/upper)
"Y" = (
/obj/machinery/atmospherics/pipe/smart/manifold4w/scrubbers/hidden/layer2,
/turf/open/floor/fakeice/slippery,
/area/station/maintenance/aft/upper)

(1,1,1) = {"
p
Y
l
"}
(2,1,1) = {"
D
I
G
"}
(3,1,1) = {"
a
a
d
"}
(4,1,1) = {"
V
y
x
"}
