//MAP CONVERTED BY dmm2tgm.py THIS HEADER COMMENT PREVENTS RECONVERSION, DO NOT REMOVE
"ae" = (
/obj/structure/musician/piano,
/turf/open/floor/wood,
/area/station/service/bar)
"ak" = (
/obj/machinery/light/directional/west,
/obj/machinery/computer/security/telescreen/entertainment/directional/west,
/turf/open/floor/cult,
/area/station/service/bar)
"bi" = (
/obj/effect/decal/cleanable/blood/splatter,
/obj/effect/decal/remains/human,
/turf/open/floor/cult,
/area/station/service/bar)
"cT" = (
/obj/machinery/computer/arcade{
	dir = 1
	},
/turf/open/floor/cult,
/area/station/service/bar)
"em" = (
/obj/structure/noticeboard/directional/south,
/turf/open/floor/cult,
/area/station/service/bar)
"eu" = (
/obj/effect/decal/cleanable/blood/splatter,
/turf/open/floor/cult,
/area/station/service/bar)
"ev" = (
/obj/machinery/newscaster/directional/south,
/turf/open/floor/cult,
/area/station/service/bar)
"eO" = (
/obj/structure/chair/wood{
	dir = 4
	},
/turf/open/floor/cult,
/area/station/service/bar)
"fa" = (
/obj/machinery/barsign,
/turf/closed/wall/mineral/cult/artificer,
/area/station/service/bar)
"fk" = (
/obj/machinery/atmospherics/pipe/smart/manifold4w/scrubbers/hidden/layer2,
/obj/machinery/atmospherics/pipe/smart/manifold4w/supply/hidden/layer4,
/turf/open/floor/cult,
/area/station/service/bar)
"fK" = (
/obj/structure/window/reinforced{
	color = "#4d2b2b";
	dir = 4
	},
/obj/machinery/door/firedoor/border_only{
	dir = 4
	},
/turf/open/floor/wood,
/area/station/service/bar)
"gf" = (
/obj/structure/chair/wood{
	dir = 4
	},
/obj/machinery/atmospherics/pipe/smart/manifold4w/scrubbers/hidden/layer2,
/obj/machinery/atmospherics/pipe/smart/manifold4w/supply/hidden/layer4,
/turf/open/floor/cult,
/area/station/service/bar)
"gA" = (
/obj/machinery/atmospherics/pipe/smart/manifold4w/scrubbers/hidden/layer2,
/obj/machinery/atmospherics/pipe/smart/manifold4w/supply/hidden/layer4,
/turf/open/floor/wood,
/area/station/service/bar)
"ja" = (
/obj/effect/decal/cleanable/blood/drip,
/turf/open/floor/cult,
/area/station/service/bar)
"jf" = (
/obj/structure/chair/wood{
	dir = 4
	},
/obj/effect/landmark/start/hangover,
/turf/open/floor/cult,
/area/station/service/bar)
"jL" = (
/obj/machinery/firealarm/directional/south,
/obj/machinery/light/directional/south,
/turf/open/floor/cult,
/area/station/service/bar)
"kL" = (
/turf/template_noop,
/area/template_noop)
"lu" = (
/obj/machinery/atmospherics/pipe/smart/manifold4w/scrubbers/hidden/layer2,
/obj/machinery/atmospherics/pipe/smart/manifold4w/supply/hidden/layer4,
/obj/structure/table/wood/fancy/red,
/obj/item/clothing/suit/hooded/cultrobes,
/turf/open/floor/cult,
/area/station/service/bar)
"mK" = (
/obj/structure/chair/wood{
	dir = 8
	},
/turf/open/floor/wood,
/area/station/service/bar)
"ng" = (
/obj/machinery/door/firedoor,
/obj/structure/table/wood/fancy/red,
/obj/structure/displaycase/forsale/kitchen,
/obj/machinery/door/poddoor/shutters/preopen{
	id = "bar_sec_shutters";
	name = "Bar Shutters";
	dir = 8
	},
/turf/open/floor/cult,
/area/station/service/bar)
"pq" = (
/obj/structure/chair/wood{
	dir = 4
	},
/obj/machinery/atmospherics/pipe/smart/manifold4w/scrubbers/hidden/layer2,
/obj/machinery/atmospherics/pipe/smart/manifold4w/supply/hidden/layer4,
/obj/effect/landmark/start/hangover,
/turf/open/floor/cult,
/area/station/service/bar)
"qb" = (
/obj/effect/landmark/start/bartender,
/turf/open/floor/cult,
/area/station/service/bar)
"qw" = (
/obj/structure/table/wood,
/obj/machinery/camera/directional/east{
	c_tag = "Service - Bar, East";
	name = "service camera"
	},
/obj/machinery/requests_console/directional/east{
	department = "Bar";
	name = "Bar Requests Console";
	supplies_requestable = 1
	},
/turf/open/floor/cult,
/area/station/service/bar)
"rS" = (
/obj/machinery/atmospherics/pipe/smart/manifold4w/scrubbers/hidden/layer2,
/obj/machinery/atmospherics/pipe/smart/manifold4w/supply/hidden/layer4,
/obj/effect/decal/cleanable/blood/old,
/obj/effect/landmark/start/assistant,
/turf/open/floor/cult,
/area/station/service/bar)
"rV" = (
/obj/structure/chair/wood,
/obj/effect/landmark/start/hangover,
/turf/open/floor/cult,
/area/station/service/bar)
"sW" = (
/obj/structure/window/reinforced{
	color = "#4d2b2b"
	},
/obj/structure/window/reinforced{
	color = "#4d2b2b";
	dir = 4
	},
/obj/machinery/door/firedoor/border_only,
/obj/machinery/door/firedoor/border_only{
	dir = 4
	},
/turf/open/floor/wood,
/area/station/service/bar)
"ta" = (
/obj/effect/decal/cleanable/blood/tracks,
/turf/open/floor/cult,
/area/station/service/bar)
"tY" = (
/obj/machinery/vending/boozeomat,
/turf/open/floor/cult,
/area/station/service/bar)
"ue" = (
/obj/structure/window/reinforced{
	color = "#4d2b2b"
	},
/obj/structure/table/wood/fancy/red,
/obj/item/instrument/violin,
/obj/machinery/door/firedoor/border_only,
/turf/open/floor/wood,
/area/station/service/bar)
"uk" = (
/obj/effect/landmark/event_spawn,
/turf/open/floor/cult,
/area/station/service/bar)
"uL" = (
/obj/machinery/door/firedoor,
/obj/machinery/door/airlock/cult/unruned/glass/friendly{
	name = "Bar"
	},
/obj/effect/mapping_helpers/airlock/access/all/service/bar,
/turf/open/floor/cult,
/area/station/service/bar)
"uS" = (
/obj/item/radio/intercom/directional/north,
/obj/machinery/camera/directional/north{
	c_tag = "Service - Bar, North";
	name = "service camera"
	},
/turf/open/floor/wood,
/area/station/service/bar)
"uV" = (
/turf/open/floor/wood,
/area/station/service/bar)
"vb" = (
/obj/effect/landmark/event_spawn,
/obj/machinery/atmospherics/components/unary/vent_scrubber/on/layer2{
	dir = 8
	},
/turf/open/floor/wood,
/area/station/service/bar)
"vj" = (
/obj/machinery/airalarm/directional/south,
/turf/open/floor/cult,
/area/station/service/bar)
"vy" = (
/obj/structure/disposalpipe/segment{
	dir = 9
	},
/obj/structure/cable,
/turf/open/floor/cult,
/area/station/service/bar)
"wp" = (
/obj/machinery/computer/slot_machine,
/obj/machinery/light/small/directional/east,
/obj/machinery/status_display/evac/directional/east,
/turf/open/floor/cult,
/area/station/service/bar)
"wz" = (
/turf/closed/wall/mineral/cult/artificer,
/area/station/service/bar)
"wM" = (
/obj/effect/spawner/structure/window/reinforced{
	color = "#4d2b2b"
	},
/turf/open/floor/plating,
/area/station/service/bar)
"zU" = (
/obj/structure/table/wood/fancy/red,
/obj/effect/landmark/event_spawn,
/turf/open/floor/cult,
/area/station/service/bar)
"AH" = (
/obj/structure/chair/wood{
	dir = 8
	},
/turf/open/floor/cult,
/area/station/service/bar)
"AZ" = (
/obj/machinery/computer/slot_machine,
/turf/open/floor/cult,
/area/station/service/bar)
"Bl" = (
/obj/machinery/door/firedoor,
/obj/machinery/door/airlock/cult/unruned/glass/friendly{
	name = "Bar"
	},
/turf/open/floor/cult,
/area/station/service/bar)
"BO" = (
/obj/effect/decal/cleanable/blood/footprints,
/turf/open/floor/cult,
/area/station/service/bar)
"Da" = (
/obj/machinery/door/window{
	dir = 4;
	name = "Theatre Stage";
	color = "#4d2b2b"
	},
/obj/machinery/door/firedoor/border_only{
	dir = 4
	},
/turf/open/floor/wood,
/area/station/service/bar)
"Dy" = (
/obj/structure/table/wood/fancy/red,
/obj/item/instrument/guitar{
	pixel_x = -7
	},
/obj/item/instrument/eguitar{
	pixel_x = 5
	},
/obj/structure/sign/poster/contraband/clown{
	pixel_x = -32
	},
/turf/open/floor/wood,
/area/station/service/bar)
"DC" = (
/obj/machinery/light/directional/west,
/obj/structure/extinguisher_cabinet/directional/west,
/obj/effect/decal/cleanable/blood/gibs/old,
/obj/effect/decal/remains/human,
/turf/open/floor/cult,
/area/station/service/bar)
"DJ" = (
/obj/machinery/computer/security/telescreen/entertainment/directional/west,
/turf/open/floor/cult,
/area/station/service/bar)
"DZ" = (
/obj/machinery/atmospherics/components/unary/vent_scrubber/on/layer2{
	dir = 8
	},
/obj/structure/table/wood/fancy/red,
/obj/item/toy/plush/moth/tyriaplush,
/turf/open/floor/cult,
/area/station/service/bar)
"FK" = (
/obj/machinery/computer/security/telescreen/entertainment/directional/east,
/turf/open/floor/cult,
/area/station/service/bar)
"FQ" = (
/obj/machinery/button/door/directional/west{
	id = "bar_sec_shutters";
	name = "Bar Shutters Control";
	desc = "Stay off my FUCKING counter.";
	req_access = list("bar")
	},
/obj/structure/sink/kitchen/directional/east,
/turf/open/floor/cult,
/area/station/service/bar)
"FU" = (
/obj/structure/table/wood,
/obj/item/book/manual/wiki/barman_recipes,
/obj/item/reagent_containers/cup/rag,
/turf/open/floor/cult,
/area/station/service/bar)
"Gh" = (
/obj/machinery/firealarm/directional/north,
/obj/structure/disposalpipe/segment{
	dir = 4
	},
/obj/machinery/atmospherics/pipe/smart/manifold4w/scrubbers/hidden/layer2,
/obj/machinery/atmospherics/pipe/smart/manifold4w/supply/hidden/layer4,
/turf/open/floor/cult,
/area/station/service/bar)
"GT" = (
/obj/machinery/atmospherics/pipe/smart/manifold4w/scrubbers/hidden/layer2,
/obj/machinery/atmospherics/pipe/smart/manifold4w/supply/hidden/layer4,
/obj/machinery/holopad,
/turf/open/floor/cult,
/area/station/service/bar)
"Hb" = (
/obj/structure/table/wood/fancy/red,
/turf/open/floor/cult,
/area/station/service/bar)
"HA" = (
/obj/machinery/atmospherics/pipe/smart/manifold4w/scrubbers/hidden/layer2,
/obj/machinery/atmospherics/pipe/smart/manifold4w/supply/hidden/layer4,
/obj/structure/chair/wood,
/turf/open/floor/cult,
/area/station/service/bar)
"HQ" = (
/obj/structure/table/wood/fancy/red,
/obj/item/toy/plush/narplush,
/turf/open/floor/cult,
/area/station/service/bar)
"Ia" = (
/obj/structure/chair/wood{
	dir = 4
	},
/obj/effect/decal/cleanable/blood/old,
/obj/effect/landmark/start/assistant,
/turf/open/floor/cult,
/area/station/service/bar)
"Ie" = (
/obj/structure/window/reinforced{
	color = "#4d2b2b"
	},
/obj/machinery/door/firedoor/border_only,
/turf/open/floor/wood,
/area/station/service/bar)
"Iy" = (
/obj/machinery/atmospherics/pipe/smart/manifold4w/supply/hidden/layer4,
/obj/machinery/atmospherics/pipe/smart/manifold4w/scrubbers/hidden/layer2,
/turf/open/floor/wood,
/area/station/service/bar)
"KM" = (
/obj/machinery/light/directional/south,
/turf/open/floor/cult,
/area/station/service/bar)
"LG" = (
/obj/structure/table/wood,
/obj/machinery/chem_dispenser/drinks/beer{
	dir = 8
	},
/turf/open/floor/cult,
/area/station/service/bar)
"LK" = (
/obj/machinery/camera/directional/south{
	c_tag = "Service - Bar, South";
	name = "service camera"
	},
/turf/open/floor/cult,
/area/station/service/bar)
"MR" = (
/obj/machinery/atmospherics/components/unary/vent_pump/on/layer4{
	dir = 4
	},
/obj/structure/table/wood/fancy/red,
/obj/item/paper/crumpled/bloody,
/turf/open/floor/cult,
/area/station/service/bar)
"Pb" = (
/obj/structure/chair/wood{
	dir = 1
	},
/obj/effect/landmark/start/hangover,
/turf/open/floor/cult,
/area/station/service/bar)
"Pt" = (
/obj/machinery/light/directional/north,
/obj/machinery/disposal/bin,
/obj/structure/disposalpipe/trunk{
	dir = 4
	},
/turf/open/floor/cult,
/area/station/service/bar)
"PC" = (
/obj/structure/extinguisher_cabinet/directional/south,
/obj/structure/table/wood,
/obj/machinery/chem_dispenser/drinks{
	dir = 8
	},
/turf/open/floor/cult,
/area/station/service/bar)
"QE" = (
/obj/machinery/light_switch/directional/north,
/obj/machinery/light/directional/north,
/turf/open/floor/wood,
/area/station/service/bar)
"RN" = (
/obj/structure/chair/wood{
	dir = 1
	},
/turf/open/floor/cult,
/area/station/service/bar)
"Sg" = (
/obj/machinery/vending/cigarette,
/turf/open/floor/cult,
/area/station/service/bar)
"SU" = (
/obj/machinery/atmospherics/components/unary/vent_pump/on/layer4{
	dir = 4
	},
/turf/open/floor/wood,
/area/station/service/bar)
"Tc" = (
/obj/structure/disposalpipe/trunk{
	dir = 4
	},
/obj/machinery/disposal/bin,
/obj/structure/cable,
/obj/machinery/power/apc/auto_name/directional/north,
/turf/open/floor/cult,
/area/station/service/bar)
"TH" = (
/obj/structure/table/wood/fancy/red,
/obj/machinery/door/firedoor,
/obj/machinery/door/poddoor/shutters/preopen{
	id = "bar_sec_shutters";
	name = "Bar Shutters";
	dir = 8
	},
/turf/open/floor/cult,
/area/station/service/bar)
"Uu" = (
/turf/open/floor/cult,
/area/station/service/bar)
"UA" = (
/obj/machinery/door/firedoor,
/obj/structure/destructible/cult/item_dispenser/archives/library,
/obj/machinery/door/poddoor/shutters/preopen{
	id = "bar_sec_shutters";
	name = "Bar Shutters";
	dir = 8
	},
/turf/open/floor/cult,
/area/station/service/bar)
"UC" = (
/obj/machinery/airalarm/directional/north,
/turf/open/floor/wood,
/area/station/service/bar)
"UN" = (
/obj/effect/decal/cleanable/blood,
/turf/open/floor/cult,
/area/station/service/bar)
"UO" = (
/obj/structure/chair/wood,
/turf/open/floor/cult,
/area/station/service/bar)
"VJ" = (
/obj/machinery/airalarm/directional/west,
/obj/machinery/camera/directional/west{
	c_tag = "Service - Bar, West";
	name = "service camera"
	},
/obj/effect/decal/cleanable/blood/tracks,
/turf/open/floor/cult,
/area/station/service/bar)
"VT" = (
/obj/structure/chair/wood{
	dir = 1
	},
/obj/effect/decal/cleanable/blood,
/mob/living/carbon/human/species/monkey/punpun,
/turf/open/floor/cult,
/area/station/service/bar)
"WG" = (
/obj/structure/disposalpipe/segment{
	dir = 9
	},
/obj/machinery/atmospherics/pipe/smart/manifold4w/scrubbers/hidden/layer2,
/obj/machinery/atmospherics/pipe/smart/manifold4w/supply/hidden/layer4,
/turf/open/floor/cult,
/area/station/service/bar)
"WM" = (
/obj/structure/chair/wood{
	dir = 8
	},
/obj/effect/landmark/start/hangover,
/turf/open/floor/cult,
/area/station/service/bar)
"Yj" = (
/obj/machinery/light/directional/north,
/obj/machinery/firealarm/directional/east,
/obj/item/radio/intercom/directional/north,
/obj/structure/table/wood,
/turf/open/floor/cult,
/area/station/service/bar)
"ZK" = (
/obj/effect/decal/cleanable/blood/old,
/obj/effect/landmark/start/assistant,
/turf/open/floor/cult,
/area/station/service/bar)

(1,1,1) = {"
kL
wz
wz
wz
wz
wz
wM
wz
Bl
wz
wM
wz
wz
"}
(2,1,1) = {"
kL
ae
Dy
ue
DJ
DC
ta
VJ
UN
ak
bi
cT
wz
"}
(3,1,1) = {"
kL
mK
uV
Ie
Uu
Uu
Uu
eO
Ia
Uu
ja
Sg
wz
"}
(4,1,1) = {"
QE
uV
SU
Ie
Uu
Uu
UO
zU
Hb
RN
Uu
ev
wz
"}
(5,1,1) = {"
gA
gA
Iy
Ie
Uu
ja
UO
MR
Hb
RN
Uu
jL
wz
"}
(6,1,1) = {"
UC
uV
vb
Ie
Uu
GT
HA
lu
HQ
VT
BO
BO
Bl
"}
(7,1,1) = {"
uS
uV
uV
Ie
Uu
fk
UO
DZ
Hb
Pb
Uu
ZK
wM
"}
(8,1,1) = {"
fK
fK
Da
sW
Uu
rS
rV
Hb
Hb
RN
Uu
Uu
Bl
"}
(9,1,1) = {"
Pt
Uu
Uu
Uu
Uu
fk
Uu
AH
WM
Uu
ja
KM
fa
"}
(10,1,1) = {"
Gh
gf
pq
fk
fk
fk
Uu
Uu
Uu
ja
Uu
LK
wz
"}
(11,1,1) = {"
WG
AZ
wp
wM
eO
eO
jf
eO
eu
Uu
Uu
em
wz
"}
(12,1,1) = {"
kL
kL
kL
kL
ng
TH
TH
TH
wz
uL
wz
UA
wz
"}
(13,1,1) = {"
kL
kL
kL
kL
Tc
Uu
Uu
qb
FQ
Uu
tY
vj
wz
"}
(14,1,1) = {"
kL
kL
kL
kL
vy
Uu
Uu
Uu
uk
Uu
Uu
KM
wz
"}
(15,1,1) = {"
kL
kL
kL
kL
Yj
FU
Uu
qw
Uu
FK
LG
PC
wz
"}
