//MAP CONVERTED BY dmm2tgm.py THIS HEADER COMMENT PREVENTS RECONVERSION, DO NOT REMOVE
"ca" = (
/obj/machinery/camera/directional/south{
	c_tag = "Service - Bar, South";
	name = "service camera"
	},
/obj/structure/fluff/clockwork/clockgolem_remains,
/turf/open/floor/bronze,
/area/station/service/bar)
"cr" = (
/obj/structure/chair/bronze{
	dir = 4
	},
/obj/machinery/atmospherics/pipe/smart/manifold4w/scrubbers/hidden/layer2,
/obj/machinery/atmospherics/pipe/smart/manifold4w/supply/hidden/layer4,
/turf/open/floor/bronze,
/area/station/service/bar)
"cu" = (
/obj/structure/window/bronze{
	dir = 4
	},
/obj/machinery/door/firedoor/border_only{
	dir = 4
	},
/turf/open/floor/bronze/flat,
/area/station/service/bar)
"du" = (
/obj/machinery/atmospherics/pipe/smart/manifold4w/supply/hidden/layer4,
/obj/machinery/atmospherics/components/unary/vent_scrubber/on/layer2{
	dir = 1
	},
/turf/open/floor/bronze,
/area/station/service/bar)
"dN" = (
/obj/structure/musician/piano,
/turf/open/floor/bronze/flat,
/area/station/service/bar)
"fc" = (
/obj/machinery/atmospherics/components/unary/vent_pump/on/layer4{
	dir = 4
	},
/turf/open/floor/bronze/flat,
/area/station/service/bar)
"fp" = (
/obj/machinery/atmospherics/pipe/smart/manifold4w/supply/hidden/layer4,
/obj/machinery/atmospherics/pipe/smart/manifold4w/scrubbers/hidden/layer2,
/turf/open/floor/bronze/flat,
/area/station/service/bar)
"fq" = (
/obj/machinery/door/firedoor,
/obj/machinery/door/airlock/bronze{
	name = "Bar"
	},
/turf/open/floor/bronze,
/area/station/service/bar)
"gg" = (
/obj/machinery/airalarm/directional/west,
/obj/machinery/camera/directional/west{
	c_tag = "Service - Bar, West";
	name = "service camera"
	},
/turf/open/floor/bronze,
/area/station/service/bar)
"hB" = (
/obj/effect/landmark/event_spawn,
/turf/open/floor/bronze/filled,
/area/station/service/bar)
"if" = (
/obj/effect/landmark/event_spawn,
/obj/machinery/atmospherics/components/unary/vent_scrubber/on/layer2{
	dir = 8
	},
/turf/open/floor/bronze/flat,
/area/station/service/bar)
"il" = (
/obj/structure/window/bronze,
/obj/machinery/door/firedoor/border_only,
/turf/open/floor/bronze/flat,
/area/station/service/bar)
"jv" = (
/obj/machinery/light_switch/directional/north,
/obj/machinery/light/directional/north,
/turf/open/floor/bronze/flat,
/area/station/service/bar)
"kq" = (
/obj/machinery/light/directional/south,
/turf/open/floor/bronze,
/area/station/service/bar)
"ll" = (
/obj/structure/chair/bronze{
	dir = 8
	},
/obj/structure/fluff/clockwork/alloy_shards,
/turf/open/floor/bronze,
/area/station/service/bar)
"lp" = (
/obj/item/radio/intercom/directional/north,
/obj/machinery/camera/directional/north{
	c_tag = "Service - Bar, North";
	name = "service camera"
	},
/turf/open/floor/bronze/flat,
/area/station/service/bar)
"mm" = (
/obj/machinery/atmospherics/pipe/smart/manifold4w/scrubbers/hidden/layer2,
/obj/machinery/atmospherics/pipe/smart/manifold4w/supply/hidden/layer4,
/turf/open/floor/bronze,
/area/station/service/bar)
"nw" = (
/obj/structure/table/bronze,
/turf/open/floor/bronze/filled,
/area/station/service/bar)
"ol" = (
/obj/machinery/light/directional/north,
/obj/item/radio/intercom/directional/north,
/obj/machinery/firealarm/directional/east,
/obj/structure/table/bronze,
/turf/open/floor/bronze/filled,
/area/station/service/bar)
"oF" = (
/obj/structure/noticeboard/directional/south,
/obj/machinery/computer/arcade{
	dir = 8
	},
/turf/open/floor/bronze,
/area/station/service/bar)
"oH" = (
/obj/machinery/vending/boozeomat,
/turf/open/floor/bronze/filled,
/area/station/service/bar)
"qn" = (
/obj/machinery/atmospherics/pipe/smart/manifold4w/scrubbers/hidden/layer2,
/obj/machinery/atmospherics/pipe/smart/manifold4w/supply/hidden/layer4,
/turf/open/floor/bronze/flat,
/area/station/service/bar)
"qG" = (
/obj/structure/window/bronze,
/obj/structure/table/bronze,
/obj/item/instrument/violin,
/obj/machinery/door/firedoor/border_only,
/turf/open/floor/bronze/flat,
/area/station/service/bar)
"qZ" = (
/obj/structure/fluff/clockwork/alloy_shards,
/turf/open/floor/bronze,
/area/station/service/bar)
"rC" = (
/obj/machinery/light/directional/north,
/obj/machinery/disposal/bin,
/obj/structure/disposalpipe/trunk{
	dir = 4
	},
/turf/open/floor/bronze,
/area/station/service/bar)
"si" = (
/obj/structure/window/bronze,
/obj/structure/window/bronze{
	dir = 4
	},
/obj/machinery/door/firedoor/border_only,
/obj/machinery/door/firedoor/border_only{
	dir = 4
	},
/turf/open/floor/bronze/flat,
/area/station/service/bar)
"sH" = (
/obj/item/toy/plush/moth/ookplush,
/turf/open/floor/bronze,
/area/station/service/bar)
"tn" = (
/obj/structure/chair/bronze{
	dir = 4
	},
/obj/machinery/atmospherics/pipe/smart/manifold4w/scrubbers/hidden/layer2,
/obj/machinery/atmospherics/pipe/smart/manifold4w/supply/hidden/layer4,
/obj/effect/landmark/start/hangover,
/turf/open/floor/bronze,
/area/station/service/bar)
"tZ" = (
/mob/living/carbon/human/species/monkey/punpun,
/turf/open/floor/bronze,
/area/station/service/bar)
"uV" = (
/obj/effect/landmark/event_spawn,
/turf/open/floor/bronze,
/area/station/service/bar)
"wY" = (
/obj/machinery/computer/security/telescreen/entertainment/directional/east,
/turf/open/floor/bronze/filled,
/area/station/service/bar)
"xT" = (
/obj/machinery/holopad,
/obj/machinery/atmospherics/pipe/smart/manifold4w/supply/hidden/layer4,
/turf/open/floor/bronze/flat,
/area/station/service/bar)
"zp" = (
/obj/machinery/barsign,
/turf/closed/wall/mineral/bronze,
/area/station/service/bar)
"Bm" = (
/obj/machinery/atmospherics/components/unary/vent_pump/on/layer4{
	dir = 1
	},
/turf/open/floor/bronze,
/area/station/service/bar)
"Cz" = (
/obj/machinery/light/directional/west,
/turf/open/floor/bronze,
/area/station/service/bar)
"DS" = (
/obj/structure/chair/bronze{
	dir = 8
	},
/turf/open/floor/bronze,
/area/station/service/bar)
"Ef" = (
/obj/structure/table/bronze,
/turf/open/floor/bronze,
/area/station/service/bar)
"Fi" = (
/obj/machinery/light/small/directional/south,
/obj/structure/extinguisher_cabinet/directional/south,
/turf/open/floor/bronze/filled,
/area/station/service/bar)
"FG" = (
/obj/machinery/firealarm/directional/south,
/obj/machinery/light/directional/south,
/turf/open/floor/bronze,
/area/station/service/bar)
"Go" = (
/obj/structure/chair/bronze{
	dir = 4
	},
/turf/open/floor/bronze,
/area/station/service/bar)
"Ie" = (
/turf/closed/wall/mineral/bronze,
/area/station/service/bar)
"Iw" = (
/obj/machinery/airalarm/directional/north,
/turf/open/floor/bronze/flat,
/area/station/service/bar)
"Jy" = (
/turf/open/floor/bronze/flat,
/area/station/service/bar)
"JZ" = (
/obj/machinery/atmospherics/pipe/smart/manifold4w/scrubbers/hidden/layer2,
/obj/machinery/atmospherics/pipe/smart/manifold4w/supply/hidden/layer4,
/obj/structure/fluff/clockwork/alloy_shards,
/turf/open/floor/bronze,
/area/station/service/bar)
"LI" = (
/turf/open/floor/bronze/filled,
/area/station/service/bar)
"LJ" = (
/obj/machinery/computer/security/telescreen/entertainment/directional/west,
/obj/machinery/vending/cigarette,
/turf/open/floor/bronze,
/area/station/service/bar)
"Mm" = (
/obj/machinery/airalarm/directional/south,
/obj/structure/table/bronze,
/obj/machinery/chem_dispenser/drinks/beer{
	dir = 4
	},
/turf/open/floor/bronze/filled,
/area/station/service/bar)
"MB" = (
/obj/machinery/door/firedoor,
/obj/structure/table/bronze,
/obj/machinery/door/poddoor/shutters/preopen{
	id = "bar_sec_shutters";
	name = "Bar Shutters";
	dir = 8
	},
/turf/open/floor/bronze,
/area/station/service/bar)
"NU" = (
/obj/machinery/firealarm/directional/north,
/obj/structure/disposalpipe/segment{
	dir = 4
	},
/obj/machinery/atmospherics/pipe/smart/manifold4w/scrubbers/hidden/layer2,
/obj/machinery/atmospherics/pipe/smart/manifold4w/supply/hidden/layer4,
/turf/open/floor/bronze,
/area/station/service/bar)
"Oh" = (
/obj/structure/table/bronze,
/obj/item/book/manual/wiki/barman_recipes,
/obj/item/reagent_containers/cup/rag,
/turf/open/floor/bronze/filled,
/area/station/service/bar)
"Ov" = (
/obj/structure/disposalpipe/trunk{
	dir = 4
	},
/obj/machinery/disposal/bin,
/obj/structure/cable,
/obj/machinery/power/apc/auto_name/directional/north,
/turf/open/floor/bronze/filled,
/area/station/service/bar)
"OD" = (
/obj/structure/disposalpipe/segment{
	dir = 9
	},
/obj/machinery/atmospherics/pipe/smart/manifold4w/scrubbers/hidden/layer2,
/obj/machinery/atmospherics/pipe/smart/manifold4w/supply/hidden/layer4,
/turf/open/floor/bronze,
/area/station/service/bar)
"Pz" = (
/obj/structure/fluff/clockwork/alloy_shards/medium,
/turf/open/floor/bronze,
/area/station/service/bar)
"PH" = (
/turf/open/floor/bronze,
/area/station/service/bar)
"PP" = (
/obj/effect/spawner/structure/window/bronze,
/turf/open/floor/plating,
/area/station/service/bar)
"Rd" = (
/obj/machinery/computer/slot_machine,
/turf/open/floor/bronze,
/area/station/service/bar)
"Rp" = (
/obj/structure/disposalpipe/segment{
	dir = 9
	},
/obj/structure/cable,
/turf/open/floor/bronze/filled,
/area/station/service/bar)
"RG" = (
/obj/structure/table/bronze,
/obj/machinery/camera/directional/east{
	c_tag = "Service - Bar, East";
	name = "service camera"
	},
/obj/machinery/requests_console/directional/east{
	department = "Bar";
	name = "Bar Requests Console";
	supplies_requestable = 1
	},
/turf/open/floor/bronze/filled,
/area/station/service/bar)
"Sf" = (
/obj/structure/table/bronze,
/obj/item/instrument/guitar{
	pixel_x = -7
	},
/obj/item/instrument/eguitar{
	pixel_x = 5
	},
/obj/structure/sign/poster/contraband/clown{
	pixel_x = -32
	},
/turf/open/floor/bronze/flat,
/area/station/service/bar)
"SA" = (
/obj/machinery/computer/slot_machine,
/obj/machinery/light/small/directional/east,
/obj/machinery/status_display/evac/directional/east,
/turf/open/floor/bronze,
/area/station/service/bar)
"Tu" = (
/obj/structure/table/bronze,
/obj/machinery/chem_dispenser/drinks{
	dir = 4
	},
/turf/open/floor/bronze/filled,
/area/station/service/bar)
"TL" = (
/obj/structure/fluff/clockwork/alloy_shards/large,
/turf/open/floor/bronze,
/area/station/service/bar)
"TO" = (
/obj/structure/chair/bronze{
	dir = 8
	},
/obj/effect/landmark/start/hangover,
/turf/open/floor/bronze,
/area/station/service/bar)
"Ui" = (
/obj/machinery/door/window{
	dir = 4;
	name = "Theatre Stage";
	color = #c09e13
	},
/obj/machinery/door/firedoor/border_only{
	dir = 4
	},
/turf/open/floor/bronze/flat,
/area/station/service/bar)
"Up" = (
/obj/machinery/button/door/directional/west{
	id = "bar_sec_shutters";
	name = "Bar Shutters Control";
	desc = "Stay off my FUCKING counter.";
	req_access = list("bar")
	},
/obj/structure/sink/kitchen/directional/east,
/turf/open/floor/bronze/filled,
/area/station/service/bar)
"Uz" = (
/obj/machinery/light/directional/west,
/obj/machinery/computer/security/telescreen/entertainment/directional/west,
/turf/open/floor/bronze,
/area/station/service/bar)
"UM" = (
/obj/effect/landmark/start/bartender,
/turf/open/floor/bronze/filled,
/area/station/service/bar)
"Wj" = (
/turf/template_noop,
/area/template_noop)
"Ww" = (
/obj/structure/chair/bronze{
	dir = 8
	},
/turf/open/floor/bronze/flat,
/area/station/service/bar)
"XG" = (
/obj/machinery/door/firedoor,
/obj/machinery/door/airlock/bronze{
	name = "Bar"
	},
/obj/effect/mapping_helpers/airlock/access/all/service/bar,
/turf/open/floor/bronze/filled,
/area/station/service/bar)
"Ya" = (
/obj/structure/fluff/clockwork/alloy_shards/small,
/obj/structure/extinguisher_cabinet/directional/south,
/turf/open/floor/bronze,
/area/station/service/bar)
"ZS" = (
/obj/machinery/door/firedoor,
/obj/structure/table/bronze,
/obj/structure/displaycase/forsale/kitchen,
/obj/machinery/door/poddoor/shutters/preopen{
	id = "bar_sec_shutters";
	name = "Bar Shutters";
	dir = 8
	},
/turf/open/floor/bronze,
/area/station/service/bar)
"ZX" = (
/obj/machinery/newscaster/directional/south,
/turf/open/floor/bronze,
/area/station/service/bar)
"ZZ" = (
/obj/structure/chair/bronze{
	dir = 4
	},
/obj/effect/landmark/start/hangover,
/turf/open/floor/bronze,
/area/station/service/bar)

(1,1,1) = {"
Wj
Ie
Ie
Ie
Ie
Ie
PP
Ie
fq
Ie
PP
Ie
Ie
"}
(2,1,1) = {"
Wj
dN
Sf
qG
LJ
Cz
PH
gg
PH
Uz
PH
sH
Ie
"}
(3,1,1) = {"
Wj
Ww
Jy
il
PH
PH
ZZ
Go
Go
Go
tZ
Ya
Ie
"}
(4,1,1) = {"
jv
Jy
fc
il
PH
TL
Ef
Ef
Ef
Ef
PH
ZX
Ie
"}
(5,1,1) = {"
qn
qn
fp
il
PH
PH
DS
ll
DS
TO
PH
FG
Ie
"}
(6,1,1) = {"
Iw
Jy
if
il
PH
mm
mm
du
xT
Bm
qZ
PH
fq
"}
(7,1,1) = {"
lp
Jy
Jy
il
PH
JZ
Go
Go
Go
Go
uV
PH
PP
"}
(8,1,1) = {"
cu
cu
Ui
si
PH
mm
Ef
Ef
Ef
Ef
PH
PH
fq
"}
(9,1,1) = {"
rC
PH
PH
PH
PH
mm
TO
DS
TO
DS
Pz
kq
zp
"}
(10,1,1) = {"
NU
cr
tn
mm
mm
mm
PH
PH
PH
PH
PH
ca
Ie
"}
(11,1,1) = {"
OD
Rd
SA
PP
Go
Go
ZZ
Go
PH
PH
PH
oF
Ie
"}
(12,1,1) = {"
Wj
Wj
Wj
Wj
ZS
MB
MB
MB
Ie
XG
Ie
Ie
Ie
"}
(13,1,1) = {"
Wj
Wj
Wj
Wj
Ov
LI
LI
UM
Up
LI
Tu
Mm
Ie
"}
(14,1,1) = {"
Wj
Wj
Wj
Wj
Rp
LI
LI
LI
LI
hB
LI
Fi
Ie
"}
(15,1,1) = {"
Wj
Wj
Wj
Wj
ol
nw
LI
RG
LI
wY
Oh
oH
Ie
"}
