//MAP CONVERTED BY dmm2tgm.py THIS HEADER COMMENT PREVENTS RECONVERSION, DO NOT REMOVE
"ae" = (
/obj/effect/turf_decal/tile/bar/opposingcorners{
	dir = 1
	},
/obj/structure/disposalpipe/trunk{
	dir = 4
	},
/obj/machinery/disposal/bin,
/obj/machinery/button/door/directional/west{
	id = "bar_sec_shutters";
	name = "Bar Shutters Control";
	desc = "Stay off my FUCKING counter.";
	req_access = list("bar")
	},
/obj/structure/cable,
/obj/machinery/power/apc/auto_name/directional/north,
/turf/open/floor/iron,
/area/station/service/bar)
"az" = (
/turf/open/floor/wood,
/area/station/service/bar)
"bN" = (
/obj/effect/turf_decal/tile/bar/opposingcorners{
	dir = 1
	},
/obj/structure/chair,
/obj/effect/landmark/start/assistant,
/turf/open/floor/iron,
/area/station/service/bar)
"cD" = (
/obj/effect/turf_decal/tile/bar/opposingcorners{
	dir = 1
	},
/mob/living/carbon/human/species/monkey/punpun,
/turf/open/floor/iron,
/area/station/service/bar)
"cH" = (
/obj/structure/chair/stool/directional/east,
/obj/machinery/atmospherics/pipe/smart/manifold4w/scrubbers/hidden/layer2,
/obj/effect/turf_decal/tile/bar/opposingcorners{
	dir = 1
	},
/obj/machinery/atmospherics/pipe/smart/manifold4w/supply/hidden/layer4,
/turf/open/floor/iron,
/area/station/service/bar)
"cL" = (
/obj/effect/turf_decal/tile/bar/opposingcorners{
	dir = 1
	},
/obj/structure/chair{
	dir = 1
	},
/obj/effect/landmark/start/hangover,
/turf/open/floor/iron,
/area/station/service/bar)
"dp" = (
/obj/machinery/barsign,
/turf/closed/wall,
/area/station/service/bar)
"dy" = (
/obj/machinery/atmospherics/pipe/smart/manifold4w/supply/hidden/layer4,
/obj/machinery/atmospherics/pipe/smart/manifold4w/scrubbers/hidden/layer2,
/turf/open/floor/wood,
/area/station/service/bar)
"ei" = (
/obj/effect/turf_decal/tile/bar/opposingcorners{
	dir = 1
	},
/obj/structure/disposalpipe/segment{
	dir = 9
	},
/obj/structure/cable,
/turf/open/floor/iron,
/area/station/service/bar)
"en" = (
/obj/effect/turf_decal/tile/bar/opposingcorners{
	dir = 1
	},
/obj/machinery/airalarm/directional/south,
/turf/open/floor/iron,
/area/station/service/bar)
"eq" = (
/obj/structure/table/wood,
/obj/item/instrument/guitar{
	pixel_x = -7
	},
/obj/item/instrument/eguitar{
	pixel_x = 5
	},
/obj/structure/sign/poster/contraband/clown{
	pixel_x = -32
	},
/turf/open/floor/wood,
/area/station/service/bar)
"eR" = (
/obj/effect/turf_decal/tile/bar/opposingcorners{
	dir = 1
	},
/obj/structure/chair/stool/bar/directional/north,
/obj/effect/landmark/event_spawn,
/turf/open/floor/iron,
/area/station/service/bar)
"fx" = (
/obj/structure/window/reinforced,
/obj/machinery/door/firedoor/border_only,
/turf/open/floor/wood,
/area/station/service/bar)
"gW" = (
/obj/effect/turf_decal/tile/bar/opposingcorners{
	dir = 1
	},
/obj/machinery/holopad,
/turf/open/floor/iron,
/area/station/service/bar)
"he" = (
/obj/effect/turf_decal/tile/bar/opposingcorners{
	dir = 1
	},
/obj/structure/table/reinforced,
/obj/machinery/computer/security/telescreen/entertainment/directional/east,
/obj/item/book/manual/wiki/barman_recipes,
/obj/machinery/door/poddoor/shutters/preopen{
	id = "bar_sec_shutters";
	name = "Bar Shutters"
	},
/obj/machinery/door/firedoor,
/obj/structure/window/reinforced{
	dir = 8
	},
/turf/open/floor/iron,
/area/station/service/bar)
"hG" = (
/obj/effect/turf_decal/tile/bar/opposingcorners{
	dir = 1
	},
/obj/machinery/airalarm/directional/west,
/obj/machinery/camera/directional/west{
	c_tag = "Service - Bar, West";
	name = "service camera"
	},
/turf/open/floor/iron,
/area/station/service/bar)
"hJ" = (
/obj/effect/turf_decal/tile/bar/opposingcorners{
	dir = 1
	},
/obj/structure/extinguisher_cabinet/directional/south,
/turf/open/floor/iron,
/area/station/service/bar)
"il" = (
/obj/effect/turf_decal/tile/bar/opposingcorners{
	dir = 1
	},
/obj/structure/table/reinforced,
/obj/item/lighter,
/obj/machinery/door/poddoor/shutters/preopen{
	id = "bar_sec_shutters";
	name = "Bar Shutters";
	dir = 8
	},
/obj/machinery/door/firedoor,
/turf/open/floor/iron,
/area/station/service/bar)
"iS" = (
/obj/effect/turf_decal/tile/bar/opposingcorners{
	dir = 1
	},
/obj/machinery/atmospherics/components/unary/vent_scrubber/on/layer2{
	dir = 8
	},
/turf/open/floor/iron,
/area/station/service/bar)
"jn" = (
/obj/effect/turf_decal/tile/bar/opposingcorners{
	dir = 1
	},
/obj/structure/table,
/obj/machinery/chem_dispenser/drinks{
	dir = 8
	},
/obj/machinery/camera/directional/east{
	c_tag = "Service - Bar, East";
	name = "service camera"
	},
/obj/machinery/requests_console/directional/east{
	department = "Bar";
	name = "Bar Requests Console";
	supplies_requestable = 1
	},
/turf/open/floor/iron,
/area/station/service/bar)
"jD" = (
/obj/effect/turf_decal/tile/bar/opposingcorners{
	dir = 1
	},
/obj/structure/chair/stool/directional/north,
/turf/open/floor/iron,
/area/station/service/bar)
"kE" = (
/obj/effect/turf_decal/tile/bar/opposingcorners{
	dir = 1
	},
/obj/structure/chair{
	dir = 8
	},
/turf/open/floor/iron,
/area/station/service/bar)
"mi" = (
/obj/effect/turf_decal/tile/bar/opposingcorners{
	dir = 1
	},
/obj/structure/chair,
/obj/effect/landmark/start/hangover,
/turf/open/floor/iron,
/area/station/service/bar)
"mB" = (
/obj/effect/turf_decal/tile/bar/opposingcorners{
	dir = 1
	},
/obj/structure/chair{
	dir = 4
	},
/turf/open/floor/iron,
/area/station/service/bar)
"od" = (
/obj/machinery/computer/slot_machine,
/obj/effect/turf_decal/tile/bar/opposingcorners{
	dir = 1
	},
/turf/open/floor/iron,
/area/station/service/bar)
"qA" = (
/obj/structure/disposalpipe/segment{
	dir = 9
	},
/obj/machinery/atmospherics/pipe/smart/manifold4w/scrubbers/hidden/layer2,
/obj/machinery/atmospherics/pipe/smart/manifold4w/supply/hidden/layer4,
/obj/effect/turf_decal/tile/bar/opposingcorners{
	dir = 1
	},
/turf/open/floor/iron,
/area/station/service/bar)
"rt" = (
/obj/effect/spawner/structure/window,
/turf/open/floor/plating,
/area/station/service/bar)
"rZ" = (
/obj/machinery/door/window{
	dir = 4;
	name = "Theatre Stage"
	},
/obj/machinery/door/firedoor/border_only{
	dir = 4
	},
/turf/open/floor/wood,
/area/station/service/bar)
"sw" = (
/obj/effect/turf_decal/tile/bar/opposingcorners{
	dir = 1
	},
/obj/structure/chair/stool/directional/west,
/turf/open/floor/iron,
/area/station/service/bar)
"sZ" = (
/turf/template_noop,
/area/template_noop)
"tH" = (
/obj/effect/turf_decal/tile/bar/opposingcorners{
	dir = 1
	},
/obj/structure/table,
/turf/open/floor/iron,
/area/station/service/bar)
"uC" = (
/obj/effect/turf_decal/tile/bar/opposingcorners{
	dir = 1
	},
/obj/machinery/firealarm/directional/south,
/obj/machinery/light/directional/south,
/turf/open/floor/iron,
/area/station/service/bar)
"uI" = (
/obj/effect/turf_decal/tile/bar/opposingcorners{
	dir = 1
	},
/obj/structure/noticeboard/directional/south,
/turf/open/floor/iron,
/area/station/service/bar)
"uU" = (
/obj/effect/turf_decal/tile/bar/opposingcorners{
	dir = 1
	},
/obj/structure/table/reinforced,
/obj/structure/displaycase/forsale/kitchen,
/obj/machinery/door/poddoor/shutters/preopen{
	id = "bar_sec_shutters";
	name = "Bar Shutters";
	dir = 8
	},
/obj/machinery/door/firedoor,
/turf/open/floor/iron,
/area/station/service/bar)
"vg" = (
/obj/machinery/airalarm/directional/north,
/turf/open/floor/wood,
/area/station/service/bar)
"vz" = (
/obj/effect/turf_decal/tile/bar/opposingcorners{
	dir = 1
	},
/obj/structure/table/wood/poker,
/obj/item/toy/cards/deck,
/obj/item/clothing/mask/cigarette/cigar,
/turf/open/floor/iron,
/area/station/service/bar)
"vO" = (
/obj/effect/turf_decal/tile/bar/opposingcorners{
	dir = 1
	},
/obj/structure/chair/stool/directional/north,
/obj/machinery/light/directional/west,
/turf/open/floor/iron,
/area/station/service/bar)
"xm" = (
/obj/structure/window/reinforced,
/obj/structure/window/reinforced{
	dir = 4
	},
/obj/machinery/door/firedoor/border_only,
/obj/machinery/door/firedoor/border_only{
	dir = 4
	},
/turf/open/floor/wood,
/area/station/service/bar)
"zc" = (
/obj/machinery/vending/boozeomat,
/turf/closed/wall,
/area/station/service/bar)
"zm" = (
/obj/effect/turf_decal/tile/bar/opposingcorners{
	dir = 1
	},
/obj/structure/table/reinforced,
/obj/machinery/door/poddoor/shutters/preopen{
	id = "bar_sec_shutters";
	name = "Bar Shutters";
	dir = 8
	},
/obj/machinery/door/firedoor,
/turf/open/floor/iron,
/area/station/service/bar)
"zF" = (
/obj/effect/turf_decal/tile/bar/opposingcorners{
	dir = 1
	},
/obj/structure/chair/stool/bar/directional/east,
/turf/open/floor/iron,
/area/station/service/bar)
"zQ" = (
/obj/effect/turf_decal/stripes/line{
	dir = 4
	},
/obj/effect/turf_decal/stripes/line{
	dir = 8
	},
/obj/machinery/door/firedoor,
/obj/machinery/door/airlock/public/glass{
	name = "Bar"
	},
/turf/open/floor/iron/textured,
/area/station/service/bar)
"Ca" = (
/obj/machinery/firealarm/directional/north,
/obj/structure/disposalpipe/segment{
	dir = 4
	},
/obj/machinery/atmospherics/pipe/smart/manifold4w/scrubbers/hidden/layer2,
/obj/machinery/atmospherics/pipe/smart/manifold4w/supply/hidden/layer4,
/obj/effect/turf_decal/tile/bar/opposingcorners{
	dir = 1
	},
/turf/open/floor/iron,
/area/station/service/bar)
"Cg" = (
/obj/machinery/atmospherics/components/unary/vent_pump/on/layer4{
	dir = 4
	},
/turf/open/floor/wood,
/area/station/service/bar)
"CA" = (
/obj/effect/turf_decal/tile/bar/opposingcorners{
	dir = 1
	},
/turf/open/floor/iron,
/area/station/service/bar)
"CQ" = (
/obj/structure/window/reinforced{
	dir = 4
	},
/obj/machinery/door/firedoor/border_only{
	dir = 4
	},
/turf/open/floor/wood,
/area/station/service/bar)
"Dt" = (
/obj/effect/turf_decal/tile/bar/opposingcorners{
	dir = 1
	},
/obj/structure/table/reinforced,
/obj/machinery/door/poddoor/shutters/preopen{
	id = "bar_sec_shutters";
	name = "Bar Shutters"
	},
/obj/machinery/door/firedoor,
/obj/structure/window/reinforced{
	dir = 4
	},
/turf/open/floor/iron,
/area/station/service/bar)
"DR" = (
/obj/effect/turf_decal/tile/bar/opposingcorners{
	dir = 1
	},
/obj/structure/chair/stool/directional/west,
/obj/effect/landmark/start/hangover,
/turf/open/floor/iron,
/area/station/service/bar)
"DU" = (
/obj/effect/turf_decal/tile/bar/opposingcorners{
	dir = 1
	},
/obj/structure/chair/stool/directional/east,
/turf/open/floor/iron,
/area/station/service/bar)
"DV" = (
/obj/effect/turf_decal/tile/bar/opposingcorners{
	dir = 1
	},
/obj/machinery/light/directional/east,
/turf/open/floor/iron,
/area/station/service/bar)
"DZ" = (
/turf/closed/wall,
/area/station/service/bar)
"Ea" = (
/obj/effect/turf_decal/stripes/line,
/obj/effect/turf_decal/stripes/line{
	dir = 1
	},
/obj/machinery/door/firedoor,
/obj/machinery/door/airlock/public/glass{
	name = "Bar"
	},
/turf/open/floor/iron/textured,
/area/station/service/bar)
"Ep" = (
/obj/machinery/light/directional/north,
/obj/machinery/disposal/bin,
/obj/structure/disposalpipe/trunk{
	dir = 4
	},
/obj/effect/turf_decal/tile/bar/opposingcorners{
	dir = 1
	},
/turf/open/floor/iron,
/area/station/service/bar)
"EF" = (
/obj/effect/turf_decal/tile/bar/opposingcorners{
	dir = 1
	},
/obj/machinery/computer/arcade{
	dir = 1
	},
/turf/open/floor/iron,
/area/station/service/bar)
"EP" = (
/obj/effect/turf_decal/tile/bar/opposingcorners{
	dir = 1
	},
/obj/structure/table,
/obj/machinery/computer/security/telescreen/entertainment/directional/west,
/obj/item/clothing/head/utility/hardhat/cakehat,
/turf/open/floor/iron,
/area/station/service/bar)
"EW" = (
/obj/effect/turf_decal/tile/bar/opposingcorners{
	dir = 1
	},
/obj/structure/table/wood/poker,
/obj/item/toy/cards/deck,
/turf/open/floor/iron,
/area/station/service/bar)
"FT" = (
/obj/machinery/atmospherics/pipe/smart/manifold4w/scrubbers/hidden/layer2,
/obj/machinery/atmospherics/pipe/smart/manifold4w/supply/hidden/layer4,
/turf/open/floor/wood,
/area/station/service/bar)
"Ga" = (
/obj/structure/musician/piano,
/turf/open/floor/wood,
/area/station/service/bar)
"Gu" = (
/obj/effect/turf_decal/tile/bar/opposingcorners{
	dir = 1
	},
/obj/effect/landmark/start/bartender,
/turf/open/floor/iron,
/area/station/service/bar)
"HF" = (
/obj/machinery/computer/slot_machine,
/obj/machinery/light/small/directional/east,
/obj/machinery/status_display/evac/directional/east,
/obj/effect/turf_decal/tile/bar/opposingcorners{
	dir = 1
	},
/turf/open/floor/iron,
/area/station/service/bar)
"Ip" = (
/obj/item/kirbyplants/random,
/obj/effect/turf_decal/tile/bar/opposingcorners{
	dir = 1
	},
/turf/open/floor/iron,
/area/station/service/bar)
"It" = (
/obj/structure/window/reinforced,
/obj/structure/table/wood,
/obj/item/instrument/violin,
/obj/machinery/door/firedoor/border_only,
/turf/open/floor/wood,
/area/station/service/bar)
"Jm" = (
/obj/effect/turf_decal/tile/bar/opposingcorners{
	dir = 1
	},
/obj/structure/chair/stool/directional/east,
/obj/effect/landmark/start/hangover,
/turf/open/floor/iron,
/area/station/service/bar)
"JF" = (
/obj/effect/turf_decal/tile/bar/opposingcorners{
	dir = 1
	},
/obj/machinery/vending/cigarette,
/turf/open/floor/iron,
/area/station/service/bar)
"Kk" = (
/obj/effect/landmark/event_spawn,
/obj/machinery/atmospherics/components/unary/vent_scrubber/on/layer2{
	dir = 8
	},
/turf/open/floor/wood,
/area/station/service/bar)
"KC" = (
/obj/effect/turf_decal/tile/bar/opposingcorners{
	dir = 1
	},
/obj/structure/chair/stool/bar/directional/east,
/obj/effect/landmark/start/hangover,
/turf/open/floor/iron,
/area/station/service/bar)
"Ly" = (
/obj/effect/turf_decal/tile/bar/opposingcorners{
	dir = 1
	},
/obj/machinery/atmospherics/components/unary/vent_pump/on/layer4{
	dir = 4
	},
/turf/open/floor/iron,
/area/station/service/bar)
"LM" = (
/obj/effect/turf_decal/tile/bar/opposingcorners{
	dir = 1
	},
/obj/machinery/light/directional/west,
/obj/machinery/computer/security/telescreen/entertainment/directional/west,
/turf/open/floor/iron,
/area/station/service/bar)
"Nm" = (
/obj/effect/turf_decal/tile/bar/opposingcorners{
	dir = 1
	},
/obj/machinery/light/directional/south,
/turf/open/floor/iron,
/area/station/service/bar)
"NZ" = (
/obj/effect/turf_decal/tile/bar/opposingcorners{
	dir = 1
	},
/obj/machinery/camera/directional/south{
	c_tag = "Service - Bar, South";
	name = "service camera"
	},
/turf/open/floor/iron,
/area/station/service/bar)
"Od" = (
/obj/effect/turf_decal/tile/bar/opposingcorners{
	dir = 1
	},
/obj/machinery/newscaster/directional/south,
/obj/item/kirbyplants/random,
/turf/open/floor/iron,
/area/station/service/bar)
"On" = (
/obj/structure/chair/stool/directional/west,
/turf/open/floor/wood,
/area/station/service/bar)
"Ov" = (
/obj/effect/turf_decal/tile/bar/opposingcorners{
	dir = 1
	},
/obj/structure/chair/stool/directional/south,
/turf/open/floor/iron,
/area/station/service/bar)
"OE" = (
/obj/effect/turf_decal/tile/bar/opposingcorners{
	dir = 1
	},
/obj/machinery/atmospherics/pipe/smart/manifold4w/scrubbers/hidden/layer2,
/obj/machinery/atmospherics/pipe/smart/manifold4w/supply/hidden/layer4,
/turf/open/floor/iron,
/area/station/service/bar)
"OS" = (
/obj/effect/turf_decal/tile/bar/opposingcorners{
	dir = 1
	},
/obj/machinery/light/small/directional/south,
/turf/open/floor/iron,
/area/station/service/bar)
"PD" = (
/obj/effect/turf_decal/tile/bar/opposingcorners{
	dir = 1
	},
/obj/structure/table/reinforced,
/obj/item/clothing/head/hats/tophat,
/obj/machinery/door/poddoor/shutters/preopen{
	id = "bar_sec_shutters";
	name = "Bar Shutters";
	dir = 8
	},
/obj/machinery/door/firedoor,
/turf/open/floor/iron,
/area/station/service/bar)
"QZ" = (
/obj/effect/turf_decal/tile/bar/opposingcorners{
	dir = 1
	},
/obj/structure/chair/stool/bar/directional/north,
/turf/open/floor/iron,
/area/station/service/bar)
"Tq" = (
/obj/effect/turf_decal/tile/bar/opposingcorners{
	dir = 1
	},
/obj/structure/chair/stool/directional/south,
/obj/machinery/atmospherics/pipe/smart/manifold4w/scrubbers/hidden/layer2,
/obj/machinery/atmospherics/pipe/smart/manifold4w/supply/hidden/layer4,
/obj/effect/landmark/start/assistant,
/turf/open/floor/iron,
/area/station/service/bar)
"TB" = (
/obj/machinery/light_switch/directional/north,
/obj/machinery/light/directional/north,
/turf/open/floor/wood,
/area/station/service/bar)
"Uq" = (
/obj/structure/chair/stool/directional/east,
/obj/machinery/atmospherics/pipe/smart/manifold4w/scrubbers/hidden/layer2,
/obj/effect/turf_decal/tile/bar/opposingcorners{
	dir = 1
	},
/obj/machinery/atmospherics/pipe/smart/manifold4w/supply/hidden/layer4,
/obj/effect/landmark/start/hangover,
/turf/open/floor/iron,
/area/station/service/bar)
"UK" = (
/obj/effect/turf_decal/tile/bar/opposingcorners{
	dir = 1
	},
/obj/structure/chair{
	dir = 1
	},
/obj/effect/landmark/start/assistant,
/turf/open/floor/iron,
/area/station/service/bar)
"Vz" = (
/obj/effect/turf_decal/tile/bar/opposingcorners{
	dir = 1
	},
/obj/machinery/door/window/right/directional/south{
	name = "Bar Door";
	req_access = list("bar")
	},
/obj/machinery/door/poddoor/shutters/preopen{
	id = "bar_sec_shutters";
	name = "Bar Shutters"
	},
/obj/machinery/door/firedoor/border_only,
/turf/open/floor/iron,
/area/station/service/bar)
"VI" = (
/obj/effect/turf_decal/tile/bar/opposingcorners{
	dir = 1
	},
/obj/item/radio/intercom/directional/north,
/obj/machinery/firealarm/directional/east,
/obj/structure/table,
/obj/machinery/chem_dispenser/drinks/beer{
	dir = 8
	},
/turf/open/floor/iron,
/area/station/service/bar)
"WG" = (
/obj/effect/turf_decal/tile/bar/opposingcorners{
	dir = 1
	},
/obj/structure/chair/stool/directional/north,
/obj/effect/landmark/start/assistant,
/turf/open/floor/iron,
/area/station/service/bar)
"XC" = (
/obj/effect/spawner/structure/window/reinforced,
/turf/open/floor/plating,
/area/station/service/bar)
"ZX" = (
/obj/item/radio/intercom/directional/north,
/obj/machinery/camera/directional/north{
	c_tag = "Service - Bar, North";
	name = "service camera"
	},
/turf/open/floor/wood,
/area/station/service/bar)

(1,1,1) = {"
sZ
DZ
DZ
DZ
DZ
DZ
XC
DZ
zQ
DZ
XC
DZ
DZ
"}
(2,1,1) = {"
sZ
Ga
eq
It
EP
vO
CA
hG
CA
LM
CA
EF
DZ
"}
(3,1,1) = {"
sZ
On
az
fx
sw
CA
mB
CA
CA
Jm
CA
JF
DZ
"}
(4,1,1) = {"
TB
az
Cg
fx
CA
bN
tH
cL
Ov
vz
WG
Od
DZ
"}
(5,1,1) = {"
FT
FT
dy
fx
CA
CA
kE
Ly
CA
sw
CA
uC
DZ
"}
(6,1,1) = {"
vg
az
Kk
fx
CA
OE
OE
OE
gW
CA
CA
CA
Ea
"}
(7,1,1) = {"
ZX
az
az
fx
CA
OE
DU
iS
CA
mB
CA
CA
XC
"}
(8,1,1) = {"
CQ
CQ
rZ
xm
CA
Tq
EW
jD
mi
tH
UK
CA
Ea
"}
(9,1,1) = {"
Ep
Ip
CA
CA
CA
OE
DR
CA
CA
kE
CA
Nm
dp
"}
(10,1,1) = {"
Ca
cH
Uq
cH
OE
OE
CA
CA
CA
CA
CA
NZ
DZ
"}
(11,1,1) = {"
qA
od
HF
od
rt
zF
zF
zF
KC
CA
CA
uI
DZ
"}
(12,1,1) = {"
sZ
sZ
sZ
sZ
DZ
uU
il
PD
zm
DZ
CA
hJ
DZ
"}
(13,1,1) = {"
sZ
sZ
sZ
sZ
ae
CA
CA
Gu
CA
Dt
eR
en
DZ
"}
(14,1,1) = {"
sZ
sZ
sZ
sZ
ei
DV
cD
CA
CA
Vz
CA
OS
DZ
"}
(15,1,1) = {"
sZ
sZ
sZ
sZ
VI
zc
CA
jn
CA
he
QZ
CA
DZ
"}
