//MAP CONVERTED BY dmm2tgm.py THIS HEADER COMMENT PREVENTS RECONVERSION, DO NOT REMOVE
"ad" = (
/obj/effect/decal/cleanable/generic,
/obj/machinery/light/small/directional/east,
/turf/open/floor/grass,
/area/station/service/bar)
"bp" = (
/obj/structure/railing{
	dir = 8
	},
/obj/effect/landmark/start/assistant,
/turf/open/floor/fakebasalt,
/area/station/service/bar)
"bD" = (
/obj/machinery/camera/directional/south{
	c_tag = "Service - Bar, South";
	name = "service camera"
	},
/turf/open/floor/grass,
/area/station/service/bar)
"cc" = (
/obj/machinery/firealarm/directional/south,
/obj/structure/disposalpipe/segment{
	dir = 9
	},
/obj/machinery/light/directional/south,
/turf/open/floor/grass,
/area/station/service/bar)
"cj" = (
/obj/machinery/light/directional/south,
/obj/effect/decal/cleanable/generic,
/turf/open/floor/grass,
/area/station/service/bar)
"ck" = (
/turf/open/floor/wood,
/area/station/service/bar)
"cI" = (
/obj/structure/window/reinforced{
	dir = 4
	},
/obj/machinery/door/firedoor/border_only{
	dir = 4
	},
/turf/open/floor/wood,
/area/station/service/bar)
"dc" = (
/obj/structure/sign/poster/official/moth_epi{
	pixel_y = -32
	},
/turf/open/floor/grass,
/area/station/service/bar)
"dx" = (
/obj/effect/mine/sound/bwoink,
/obj/item/spear,
/turf/open/floor/grass,
/area/station/service/bar)
"ew" = (
/obj/structure/disposalpipe/segment{
	dir = 9
	},
/obj/machinery/atmospherics/pipe/smart/manifold4w/scrubbers/hidden/layer2,
/obj/machinery/atmospherics/pipe/smart/manifold4w/supply/hidden/layer4,
/turf/open/floor/grass,
/area/station/service/bar)
"fm" = (
/obj/machinery/atmospherics/pipe/smart/manifold4w/scrubbers/hidden/layer2,
/obj/machinery/atmospherics/pipe/smart/manifold4w/supply/hidden/layer4,
/obj/structure/disposalpipe/segment,
/turf/open/floor/grass,
/area/station/service/bar)
"fz" = (
/obj/machinery/atmospherics/pipe/smart/manifold4w/scrubbers/hidden/layer2,
/obj/machinery/atmospherics/pipe/smart/manifold4w/supply/hidden/layer4,
/obj/structure/disposalpipe/segment{
	dir = 4
	},
/turf/open/floor/grass,
/area/station/service/bar)
"gy" = (
/obj/item/melee/roastingstick,
/obj/item/food/sausage,
/turf/open/floor/grass,
/area/station/service/bar)
"gL" = (
/obj/structure/table/wood,
/obj/machinery/chem_dispenser/drinks/beer{
	dir = 1
	},
/obj/item/radio/intercom/directional/south,
/turf/open/misc/dirt/jungle,
/area/station/service/bar)
"gY" = (
/obj/machinery/computer/slot_machine,
/turf/open/floor/grass,
/area/station/service/bar)
"hS" = (
/obj/machinery/atmospherics/pipe/smart/manifold4w/supply/hidden/layer4,
/obj/machinery/atmospherics/pipe/smart/manifold4w/scrubbers/hidden/layer2,
/obj/machinery/holopad,
/turf/open/floor/wood,
/area/station/service/bar)
"ir" = (
/turf/closed/wall/mineral/wood,
/area/station/service/bar)
"jh" = (
/obj/structure/window/reinforced,
/obj/structure/table/wood,
/obj/item/instrument/violin,
/obj/machinery/door/firedoor/border_only,
/turf/open/floor/wood,
/area/station/service/bar)
"jy" = (
/obj/machinery/atmospherics/pipe/smart/manifold4w/scrubbers/hidden/layer2,
/obj/machinery/atmospherics/pipe/smart/manifold4w/supply/hidden/layer4,
/obj/structure/flora/bush/large/style_random,
/obj/item/toy/plush/moth,
/turf/open/floor/grass,
/area/station/service/bar)
"jB" = (
/obj/structure/flora/rock/pile/jungle/style_random,
/turf/open/water/jungle,
/area/station/service/bar)
"jK" = (
/obj/structure/musician/piano,
/turf/open/floor/wood,
/area/station/service/bar)
"kD" = (
/obj/structure/table/wood,
/obj/machinery/door/firedoor,
/obj/machinery/door/poddoor/shutters/preopen{
	id = "bar_sec_shutters";
	name = "Bar Shutters";
	dir = 1
	},
/obj/structure/displaycase/forsale/kitchen{
	pixel_y = 10
	},
/turf/open/misc/dirt/jungle,
/area/station/service/bar)
"lY" = (
/obj/machinery/airalarm/directional/north,
/turf/open/floor/wood,
/area/station/service/bar)
"mu" = (
/obj/machinery/door/firedoor,
/obj/structure/barricade/wooden,
/obj/structure/barricade/wooden/crude,
/obj/machinery/door/poddoor/shutters/preopen{
	id = "bar_sec_shutters";
	name = "Bar Shutter";
	dir = 8
	},
/turf/open/misc/dirt/jungle,
/area/station/service/bar)
"mB" = (
/obj/machinery/light/directional/west,
/obj/machinery/computer/arcade{
	dir = 4
	},
/obj/structure/sign/poster/contraband/syndiemoth{
	pixel_x = -32
	},
/turf/open/floor/grass,
/area/station/service/bar)
"mC" = (
/obj/machinery/light/directional/north,
/obj/machinery/disposal/bin,
/obj/structure/disposalpipe/trunk{
	dir = 4
	},
/turf/open/floor/grass,
/area/station/service/bar)
"mL" = (
/turf/open/water/jungle,
/area/station/service/bar)
"mP" = (
/obj/machinery/atmospherics/components/unary/vent_pump/on/layer4{
	dir = 4
	},
/turf/open/floor/wood,
/area/station/service/bar)
"nj" = (
/obj/machinery/atmospherics/pipe/smart/manifold4w/scrubbers/hidden/layer2,
/obj/machinery/atmospherics/pipe/smart/manifold4w/supply/hidden/layer4,
/turf/open/water/jungle,
/area/station/service/bar)
"nw" = (
/obj/structure/flora/grass/jungle/b/style_random,
/turf/open/floor/grass,
/area/station/service/bar)
"nB" = (
/obj/effect/landmark/start/assistant,
/turf/open/floor/fakebasalt,
/area/station/service/bar)
"nI" = (
/obj/structure/table/wood,
/obj/item/instrument/guitar{
	pixel_x = -7
	},
/obj/item/instrument/eguitar{
	pixel_x = 5
	},
/obj/structure/sign/poster/contraband/clown{
	pixel_x = -32
	},
/turf/open/floor/wood,
/area/station/service/bar)
"nN" = (
/obj/machinery/camera/directional/east{
	c_tag = "Service - Bar, East";
	name = "service camera"
	},
/turf/open/floor/grass,
/area/station/service/bar)
"nR" = (
/obj/effect/decal/cleanable/generic,
/turf/open/floor/grass,
/area/station/service/bar)
"nU" = (
/obj/structure/flora/grass/jungle/a/style_random,
/turf/open/floor/grass,
/area/station/service/bar)
"op" = (
/obj/structure/chair/wood,
/obj/effect/landmark/start/hangover,
/obj/effect/decal/cleanable/ash{
	pixel_x = 10;
	pixel_y = 6
	},
/obj/item/trash/can{
	pixel_x = 21;
	pixel_y = -5
	},
/turf/open/floor/grass,
/area/station/service/bar)
"pg" = (
/obj/machinery/atmospherics/components/unary/vent_scrubber/on/layer2{
	dir = 4
	},
/turf/open/floor/grass,
/area/station/service/bar)
"po" = (
/obj/item/radio/intercom/directional/north,
/obj/machinery/camera/directional/north{
	c_tag = "Service - Bar, North";
	name = "service camera"
	},
/turf/open/floor/wood,
/area/station/service/bar)
"py" = (
/obj/structure/flora/bush/large/style_random,
/turf/open/floor/grass,
/area/station/service/bar)
"pK" = (
/obj/item/radio/intercom/directional/north,
/obj/machinery/firealarm/directional/east,
/turf/open/floor/grass,
/area/station/service/bar)
"pP" = (
/obj/effect/landmark/start/bartender,
/turf/open/misc/dirt/jungle,
/area/station/service/bar)
"qi" = (
/obj/structure/window/reinforced,
/obj/machinery/door/firedoor/border_only,
/turf/open/floor/wood,
/area/station/service/bar)
"ru" = (
/obj/structure/disposalpipe/segment{
	dir = 4
	},
/obj/structure/sign/poster/official/moth_epi{
	pixel_y = -32
	},
/turf/open/floor/grass,
/area/station/service/bar)
"sD" = (
/obj/machinery/computer/slot_machine,
/obj/machinery/light/small/directional/east,
/obj/machinery/status_display/evac/directional/east,
/turf/open/floor/grass,
/area/station/service/bar)
"tT" = (
/obj/machinery/door/airlock/wood,
/turf/open/floor/fakebasalt,
/area/station/service/bar)
"tU" = (
/obj/structure/chair/wood,
/turf/open/floor/grass,
/area/station/service/bar)
"ud" = (
/turf/open/floor/fakepit,
/area/station/service/bar)
"uo" = (
/obj/structure/disposalpipe/trunk{
	dir = 4
	},
/obj/machinery/disposal/bin,
/obj/machinery/newscaster/directional/south,
/turf/open/floor/grass,
/area/station/service/bar)
"vc" = (
/turf/open/floor/grass,
/area/station/service/bar)
"vv" = (
/obj/structure/chair/wood{
	dir = 4
	},
/obj/machinery/atmospherics/pipe/smart/manifold4w/scrubbers/hidden/layer2,
/obj/machinery/atmospherics/pipe/smart/manifold4w/supply/hidden/layer4,
/turf/open/floor/grass,
/area/station/service/bar)
"vy" = (
/obj/structure/flora/rock/pile/jungle/large/style_random,
/obj/structure/flora/tree/jungle/style_random,
/turf/open/floor/grass,
/area/station/service/bar)
"vS" = (
/obj/structure/table/wood,
/obj/machinery/chem_dispenser/drinks{
	dir = 1
	},
/obj/machinery/requests_console/directional/south{
	department = "Bar";
	name = "Bar Requests Console";
	supplies_requestable = 1
	},
/obj/machinery/firealarm/directional/west,
/turf/open/misc/dirt/jungle,
/area/station/service/bar)
"wh" = (
/obj/machinery/light_switch/directional/north,
/obj/machinery/light/directional/north,
/turf/open/floor/wood,
/area/station/service/bar)
"wF" = (
/obj/structure/window/reinforced,
/obj/structure/window/reinforced{
	dir = 4
	},
/obj/machinery/door/firedoor/border_only,
/obj/machinery/door/firedoor/border_only{
	dir = 4
	},
/turf/open/floor/wood,
/area/station/service/bar)
"wM" = (
/obj/machinery/computer/security/telescreen/entertainment/directional/east,
/turf/open/floor/grass,
/area/station/service/bar)
"xk" = (
/obj/effect/landmark/event_spawn,
/turf/open/floor/grass,
/area/station/service/bar)
"xK" = (
/obj/machinery/computer/security/telescreen/entertainment/directional/west,
/obj/structure/table/wood,
/obj/machinery/door/firedoor,
/obj/machinery/door/poddoor/shutters/preopen{
	id = "bar_sec_shutters";
	name = "Bar Shutters";
	dir = 1
	},
/turf/open/misc/dirt/jungle,
/area/station/service/bar)
"ya" = (
/obj/structure/railing,
/turf/open/floor/fakebasalt,
/area/station/service/bar)
"yJ" = (
/turf/template_noop,
/area/template_noop)
"zh" = (
/obj/structure/table/wood,
/obj/machinery/door/firedoor,
/obj/machinery/door/poddoor/shutters/preopen{
	id = "bar_sec_shutters";
	name = "Bar Shutters";
	dir = 1
	},
/turf/open/misc/dirt/jungle,
/area/station/service/bar)
"zv" = (
/obj/structure/table/wood,
/obj/item/book/manual/wiki/barman_recipes,
/obj/item/lighter,
/obj/machinery/button/door/directional/east{
	desc = "Stay off my FUCKING counter.";
	id = "bar_sec_shutters";
	name = "Bar Shutters Control";
	req_access = list("bar")
	},
/obj/machinery/light_switch/directional/south,
/turf/open/misc/dirt/jungle,
/area/station/service/bar)
"AS" = (
/obj/effect/landmark/start/assistant,
/turf/open/floor/grass,
/area/station/service/bar)
"Bs" = (
/obj/structure/disposalpipe/segment{
	dir = 6
	},
/mob/living/carbon/human/species/monkey/punpun,
/turf/open/floor/grass,
/area/station/service/bar)
"BD" = (
/obj/structure/barricade/wooden,
/obj/structure/barricade/wooden/crude,
/turf/open/floor/fakebasalt,
/area/station/service/bar)
"Ck" = (
/obj/structure/noticeboard/directional/south,
/obj/structure/flora/grass/jungle/a/style_random,
/turf/open/floor/grass,
/area/station/service/bar)
"CV" = (
/obj/structure/extinguisher_cabinet/directional/south,
/turf/open/floor/grass,
/area/station/service/bar)
"Dd" = (
/obj/machinery/door/firedoor,
/obj/machinery/door/airlock/wood,
/obj/effect/mapping_helpers/airlock/access/all/service/bar,
/turf/open/misc/dirt/jungle,
/area/station/service/bar)
"Dg" = (
/obj/structure/disposalpipe/segment{
	dir = 9
	},
/obj/structure/cable,
/turf/open/floor/grass,
/area/station/service/bar)
"EB" = (
/obj/machinery/vending/boozeomat,
/obj/machinery/airalarm/directional/south,
/obj/machinery/light/directional/south,
/turf/open/misc/dirt/jungle,
/area/station/service/bar)
"FS" = (
/obj/structure/disposalpipe/segment{
	dir = 4
	},
/turf/open/water/jungle,
/area/station/service/bar)
"Gi" = (
/obj/machinery/door/window{
	dir = 4;
	name = "Theatre Stage"
	},
/obj/machinery/door/firedoor/border_only{
	dir = 4
	},
/turf/open/floor/wood,
/area/station/service/bar)
"GX" = (
/obj/structure/disposalpipe/segment{
	dir = 4
	},
/turf/open/floor/grass,
/area/station/service/bar)
"Hh" = (
/obj/structure/chair/wood{
	dir = 4
	},
/obj/machinery/atmospherics/pipe/smart/manifold4w/scrubbers/hidden/layer2,
/obj/machinery/atmospherics/pipe/smart/manifold4w/supply/hidden/layer4,
/obj/effect/landmark/start/hangover,
/turf/open/floor/grass,
/area/station/service/bar)
"HA" = (
/obj/machinery/vending/cigarette,
/turf/open/floor/grass,
/area/station/service/bar)
"HI" = (
/obj/effect/decal/cleanable/generic,
/obj/machinery/camera/directional/west{
	c_tag = "Service - Bar, West";
	name = "service camera"
	},
/turf/open/floor/grass,
/area/station/service/bar)
"Im" = (
/obj/structure/chair/wood{
	dir = 8
	},
/turf/open/floor/wood,
/area/station/service/bar)
"Kc" = (
/obj/machinery/atmospherics/pipe/smart/manifold4w/scrubbers/hidden/layer2,
/obj/machinery/atmospherics/pipe/smart/manifold4w/supply/hidden/layer4,
/obj/structure/disposalpipe/segment,
/obj/effect/landmark/event_spawn,
/turf/open/floor/grass,
/area/station/service/bar)
"Mu" = (
/obj/structure/flora/rock/pile/jungle/style_random,
/obj/structure/flora/tree/jungle/small/style_random,
/turf/open/floor/grass,
/area/station/service/bar)
"MI" = (
/obj/effect/landmark/event_spawn,
/obj/machinery/atmospherics/components/unary/vent_scrubber/on/layer2{
	dir = 8
	},
/turf/open/floor/wood,
/area/station/service/bar)
"NP" = (
/obj/effect/mine/sound/bwoink,
/turf/open/floor/grass,
/area/station/service/bar)
"NV" = (
/obj/machinery/atmospherics/components/unary/vent_pump/on/layer4{
	dir = 4
	},
/turf/open/floor/grass,
/area/station/service/bar)
"Ol" = (
/obj/machinery/barsign,
/turf/closed/wall/mineral/wood,
/area/station/service/bar)
"Oz" = (
/obj/structure/flora/bush/jungle/a/style_random,
/turf/open/floor/grass,
/area/station/service/bar)
"OP" = (
/obj/structure/disposalpipe/segment{
	dir = 4
	},
/obj/structure/cable,
/obj/machinery/power/apc/auto_name/directional/north,
/turf/open/floor/grass,
/area/station/service/bar)
"OY" = (
/obj/structure/bonfire/prelit,
/turf/open/misc/dirt/jungle,
/area/station/service/bar)
"QB" = (
/obj/machinery/light/small/directional/south,
/obj/structure/flora/grass/jungle/b/style_random,
/obj/machinery/airalarm/directional/south,
/turf/open/floor/grass,
/area/station/service/bar)
"QO" = (
/obj/machinery/computer/security/telescreen/entertainment/directional/west,
/turf/open/floor/grass,
/area/station/service/bar)
"QW" = (
/turf/open/misc/dirt/jungle,
/area/station/service/bar)
"TV" = (
/obj/machinery/atmospherics/pipe/smart/manifold4w/scrubbers/hidden/layer2,
/obj/machinery/atmospherics/pipe/smart/manifold4w/supply/hidden/layer4,
/turf/open/floor/wood,
/area/station/service/bar)
"Ub" = (
/obj/machinery/firealarm/directional/north,
/obj/structure/disposalpipe/segment{
	dir = 4
	},
/obj/machinery/atmospherics/pipe/smart/manifold4w/scrubbers/hidden/layer2,
/obj/machinery/atmospherics/pipe/smart/manifold4w/supply/hidden/layer4,
/turf/open/floor/grass,
/area/station/service/bar)
"Yd" = (
/obj/structure/disposalpipe/segment{
	dir = 4
	},
/obj/structure/flora/grass/jungle/a/style_random,
/turf/open/floor/grass,
/area/station/service/bar)
"Yt" = (
/obj/machinery/atmospherics/pipe/smart/manifold4w/scrubbers/hidden/layer2,
/obj/machinery/atmospherics/pipe/smart/manifold4w/supply/hidden/layer4,
/obj/machinery/light/directional/east,
/turf/open/floor/grass,
/area/station/service/bar)
"YM" = (
/obj/machinery/door/firedoor,
/obj/machinery/door/airlock/wood,
/turf/open/misc/dirt/jungle,
/area/station/service/bar)
"ZB" = (
/obj/machinery/door/firedoor,
/obj/structure/barricade/wooden,
/obj/structure/barricade/wooden/crude,
/turf/open/misc/dirt/jungle,
/area/station/service/bar)

(1,1,1) = {"
yJ
ir
ir
ir
ir
ir
YM
ir
ZB
ir
mu
ir
ir
"}
(2,1,1) = {"
yJ
jK
nI
jh
QO
mB
vc
HI
tU
xK
pP
vS
ir
"}
(3,1,1) = {"
yJ
Im
ck
qi
vc
dx
Mu
vc
AS
zh
QW
EB
ir
"}
(4,1,1) = {"
wh
ck
mP
qi
vc
vc
vc
nU
op
kD
pP
gL
ir
"}
(5,1,1) = {"
TV
TV
hS
qi
nR
Oz
pg
NV
uo
ir
QW
zv
ir
"}
(6,1,1) = {"
lY
ck
MI
qi
Bs
fm
fm
Kc
cc
ir
Dd
ir
ir
"}
(7,1,1) = {"
po
ck
ck
qi
FS
nj
jB
mL
mL
mL
mL
mL
ZB
"}
(8,1,1) = {"
cI
cI
Gi
wF
FS
nj
mL
mL
mL
mL
jB
mL
YM
"}
(9,1,1) = {"
mC
vc
vc
vc
GX
jy
vc
OY
gy
vc
vc
cj
Ol
"}
(10,1,1) = {"
Ub
vv
Hh
vv
fz
Yt
nw
vc
vc
NP
Mu
bD
ir
"}
(11,1,1) = {"
ew
gY
sD
gY
Yd
ir
tT
ir
ir
vc
vc
Ck
ir
"}
(12,1,1) = {"
yJ
yJ
yJ
yJ
ru
ir
ya
ud
BD
HA
py
CV
ir
"}
(13,1,1) = {"
yJ
yJ
yJ
yJ
OP
ir
nB
bp
ir
vc
xk
dc
ir
"}
(14,1,1) = {"
yJ
yJ
yJ
yJ
Dg
ir
ir
ir
ir
NP
vy
QB
ir
"}
(15,1,1) = {"
yJ
yJ
yJ
yJ
pK
ad
vc
nN
vc
wM
vc
vc
ir
"}
