//MAP CONVERTED BY dmm2tgm.py THIS HEADER COMMENT PREVENTS RECONVERSION, DO NOT REMOVE
"af" = (
/obj/structure/cable,
/obj/machinery/camera/directional/south{
	c_tag = "Engineering Supermatter Aft";
	network = list("ss13","engine")
	},
/obj/effect/turf_decal/trimline/yellow/arrow_ccw,
/obj/effect/turf_decal/trimline/yellow/arrow_cw{
	dir = 1
	},
/turf/open/floor/plating,
/area/station/engineering/supermatter/room)
"br" = (
/obj/structure/lattice,
/obj/effect/spawner/random/structure/grille,
/turf/open/space/basic,
/area/space/nearstation)
"bY" = (
/obj/effect/turf_decal/stripes/line{
	dir = 1
	},
/obj/machinery/portable_atmospherics/canister/nitrogen,
/turf/open/floor/plating,
/area/station/engineering/supermatter)
"cP" = (
/obj/effect/turf_decal/stripes/line{
	dir = 4
	},
/turf/open/floor/plating,
/area/station/engineering/supermatter)
"cT" = (
/obj/effect/turf_decal/stripes/corner,
/turf/open/floor/plating,
/area/station/engineering/supermatter)
"dx" = (
/obj/effect/turf_decal/stripes/line{
	dir = 8
	},
/obj/machinery/light/floor/has_bulb,
/turf/open/floor/plating,
/area/station/engineering/supermatter)
"eg" = (
/obj/item/holosign_creator/atmos,
/turf/open/floor/plating,
/area/station/engineering/supermatter)
"eH" = (
/obj/effect/spawner/structure/window/reinforced/plasma,
/obj/machinery/atmospherics/pipe/smart/manifold4w/supply/hidden/layer4,
/turf/open/floor/plating,
/area/station/engineering/supermatter)
"gQ" = (
/obj/structure/cable,
/obj/effect/turf_decal/trimline/yellow/arrow_cw{
	dir = 1
	},
/obj/effect/turf_decal/trimline/yellow/arrow_ccw,
/turf/open/floor/plating,
/area/station/engineering/supermatter/room)
"gU" = (
/obj/effect/turf_decal/stripes/line{
	dir = 1
	},
/obj/machinery/light/floor/has_bulb,
/turf/open/floor/plating,
/area/station/engineering/supermatter)
"iY" = (
/obj/effect/turf_decal/stripes/line,
/turf/open/floor/plating,
/area/station/engineering/supermatter)
"je" = (
/turf/template_noop,
/area/space)
"jw" = (
/obj/machinery/power/energy_accumulator/tesla_coil,
/turf/open/floor/plating,
/area/station/engineering/supermatter)
"kf" = (
/obj/machinery/door/firedoor,
/obj/machinery/door/airlock/engineering/glass{
	name = "Supermatter Engine Room"
	},
/obj/effect/mapping_helpers/airlock/access/all/engineering/general,
/turf/open/floor/plating,
/area/station/engineering/supermatter)
"kK" = (
/turf/template_noop,
/area/template_noop)
"kO" = (
/obj/effect/spawner/structure/window/reinforced/plasma,
/turf/open/floor/plating,
/area/station/engineering/supermatter/room)
"lj" = (
/obj/effect/turf_decal/stripes/line,
/obj/machinery/power/apc/worn_out/directional/south,
/turf/open/floor/plating,
/area/station/engineering/supermatter)
"lX" = (
/obj/machinery/atmospherics/pipe/smart/manifold4w/scrubbers/visible,
/obj/machinery/meter,
/turf/closed/wall/r_wall,
/area/station/engineering/supermatter/room)
"mO" = (
/obj/structure/cable,
/obj/machinery/power/apc/worn_out/directional/south,
/obj/effect/turf_decal/trimline/yellow/arrow_ccw{
	dir = 6
	},
/obj/effect/turf_decal/trimline/yellow/corner{
	dir = 1
	},
/turf/open/floor/plating,
/area/station/engineering/supermatter/room)
"np" = (
/obj/structure/sign/directions/ptl/directional/east,
/turf/open/floor/plating,
/area/station/engineering/supermatter/room)
"nu" = (
/obj/machinery/power/energy_accumulator/grounding_rod,
/turf/open/floor/plating,
/area/station/engineering/supermatter)
"oJ" = (
/obj/effect/turf_decal/stripes/line{
	dir = 9
	},
/obj/machinery/portable_atmospherics/canister/nitrogen,
/turf/open/floor/plating,
/area/station/engineering/supermatter)
"oW" = (
/obj/machinery/light/directional/east,
/turf/open/floor/plating,
/area/station/engineering/supermatter/room)
"qx" = (
/obj/effect/turf_decal/stripes/line{
	dir = 8
	},
/turf/open/floor/plating,
/area/station/engineering/supermatter)
"qz" = (
/obj/machinery/door/firedoor,
/obj/machinery/door/airlock/engineering/glass{
	name = "Supermatter Engine Room"
	},
/obj/machinery/atmospherics/pipe/smart/manifold4w/supply/hidden/layer4,
/obj/machinery/atmospherics/pipe/smart/manifold4w/scrubbers/hidden/layer2,
/obj/effect/mapping_helpers/airlock/access/all/engineering/general,
/turf/open/floor/iron/dark,
/area/station/engineering/supermatter/room)
"rs" = (
/obj/item/wrench,
/turf/open/floor/plating,
/area/station/engineering/supermatter/room)
"sR" = (
/obj/effect/turf_decal/stripes/line,
/obj/machinery/airalarm/engine{
	pixel_y = -24
	},
/turf/open/floor/plating,
/area/station/engineering/supermatter)
"tg" = (
/obj/effect/turf_decal/delivery,
/turf/open/floor/plating,
/area/station/engineering/supermatter)
"tp" = (
/obj/structure/lattice,
/obj/machinery/atmospherics/components/unary/passive_vent{
	dir = 8
	},
/turf/template_noop,
/area/space/nearstation)
"tA" = (
/obj/structure/reflector/box,
/turf/open/floor/plating,
/area/station/engineering/supermatter/room)
"tO" = (
/obj/structure/lattice/catwalk,
/turf/open/space,
/area/space/nearstation)
"vI" = (
/turf/open/space,
/area/space/nearstation)
"vM" = (
/turf/open/floor/plating,
/area/station/engineering/supermatter)
"vY" = (
/obj/machinery/atmospherics/components/unary/thermomachine/freezer{
	dir = 8
	},
/turf/open/floor/plating,
/area/station/engineering/supermatter/room)
"wm" = (
/obj/machinery/firealarm/directional/north,
/turf/open/floor/plating,
/area/station/engineering/supermatter/room)
"wo" = (
/obj/structure/sign/warning/no_smoking,
/turf/closed/wall/r_wall,
/area/station/engineering/supermatter)
"xe" = (
/obj/effect/mapping_helpers/broken_floor,
/turf/open/floor/plating/airless,
/area/space/nearstation)
"yn" = (
/obj/structure/closet/crate/engineering{
	name = "supermatter shard crate"
	},
/obj/machinery/power/supermatter_crystal/shard,
/turf/open/floor/plating,
/area/station/engineering/supermatter)
"yt" = (
/obj/structure/lattice,
/turf/open/space,
/area/space/nearstation)
"yM" = (
/obj/effect/turf_decal/stripes/line{
	dir = 6
	},
/turf/open/floor/plating,
/area/station/engineering/supermatter)
"yT" = (
/obj/item/stack/sheet/plasmarglass/fifty{
	pixel_x = -8
	},
/obj/structure/closet/crate/engineering{
	name = "additional materials crate"
	},
/obj/item/stack/sheet/plasteel/fifty{
	pixel_x = 8
	},
/turf/open/floor/plating,
/area/station/engineering/supermatter)
"yW" = (
/obj/effect/turf_decal/stripes/line{
	dir = 10
	},
/obj/machinery/atmospherics/pipe/smart/manifold4w/supply/hidden/layer4,
/turf/open/floor/plating,
/area/station/engineering/supermatter)
"zi" = (
/obj/machinery/status_display/ai/directional/east,
/turf/open/floor/plating,
/area/station/engineering/supermatter/room)
"zC" = (
/obj/structure/reflector/single,
/turf/open/floor/plating,
/area/station/engineering/supermatter/room)
"Av" = (
/obj/structure/lattice,
/turf/open/space/basic,
/area/space/nearstation)
"Ay" = (
/obj/machinery/airalarm/directional/south,
/obj/machinery/power/smes/engineering,
/obj/structure/cable,
/turf/open/floor/plating,
/area/station/engineering/supermatter/room)
"AG" = (
/obj/effect/turf_decal/stripes/line{
	dir = 4
	},
/obj/machinery/light/directional/east,
/turf/open/floor/plating,
/area/station/engineering/supermatter)
"Bc" = (
/obj/effect/turf_decal/stripes/line,
/obj/machinery/atmospherics/components/binary/pump{
	dir = 1;
	name = "Atmos to Loop"
	},
/turf/open/floor/plating,
/area/station/engineering/supermatter)
"Bo" = (
/obj/effect/turf_decal/stripes/line{
	dir = 9
	},
/turf/open/floor/plating,
/area/station/engineering/supermatter)
"Bx" = (
/obj/effect/turf_decal/stripes/line{
	dir = 4
	},
/obj/machinery/light/floor/has_bulb,
/turf/open/floor/plating,
/area/station/engineering/supermatter)
"BQ" = (
/obj/effect/turf_decal/stripes/line,
/obj/machinery/light/floor/has_bulb,
/turf/open/floor/plating,
/area/station/engineering/supermatter)
"CY" = (
/obj/effect/turf_decal/stripes/corner{
	dir = 1
	},
/turf/open/floor/plating,
/area/station/engineering/supermatter)
"Dk" = (
/obj/structure/cable,
/obj/machinery/power/terminal{
	dir = 4
	},
/obj/effect/turf_decal/trimline/yellow/arrow_ccw,
/obj/effect/turf_decal/trimline/yellow/arrow_cw{
	dir = 1
	},
/turf/open/floor/plating,
/area/station/engineering/supermatter/room)
"EU" = (
/obj/machinery/atmospherics/pipe/smart/manifold4w/scrubbers/hidden/layer2,
/obj/machinery/atmospherics/pipe/smart/manifold4w/supply/hidden/layer4,
/turf/open/floor/plating,
/area/station/engineering/supermatter/room)
"GG" = (
/obj/effect/turf_decal/stripes/line{
	dir = 8
	},
/obj/structure/cable,
/obj/effect/turf_decal/trimline/yellow/arrow_cw,
/obj/effect/turf_decal/trimline/yellow/arrow_ccw{
	dir = 1
	},
/turf/open/floor/plating,
/area/station/engineering/supermatter)
"GH" = (
/obj/effect/turf_decal/stripes/line,
/obj/machinery/firealarm/directional/south,
/turf/open/floor/plating,
/area/station/engineering/supermatter)
"HD" = (
/obj/effect/turf_decal/stripes/line{
	dir = 4
	},
/obj/machinery/power/energy_accumulator/grounding_rod,
/turf/open/floor/plating,
/area/station/engineering/supermatter)
"HO" = (
/obj/effect/turf_decal/stripes/corner{
	dir = 8
	},
/turf/open/floor/plating,
/area/station/engineering/supermatter)
"Ib" = (
/obj/structure/sign/warning/secure_area,
/turf/closed/wall/r_wall,
/area/station/engineering/supermatter)
"ID" = (
/obj/effect/turf_decal/stripes/corner{
	dir = 4
	},
/obj/machinery/power/energy_accumulator/tesla_coil,
/turf/open/floor/plating,
/area/station/engineering/supermatter)
"IH" = (
/obj/effect/mapping_helpers/burnt_floor,
/turf/open/floor/plating/airless,
/area/space/nearstation)
"Jc" = (
/obj/structure/cable,
/obj/effect/turf_decal/trimline/yellow/arrow_cw{
	dir = 8
	},
/obj/effect/turf_decal/trimline/yellow/arrow_ccw{
	dir = 4
	},
/turf/open/floor/plating,
/area/station/engineering/supermatter/room)
"Je" = (
/obj/machinery/door/airlock/engineering/glass{
	name = "PTL Room"
	},
/obj/effect/mapping_helpers/airlock/access/all/engineering/general,
/obj/structure/cable,
/turf/open/floor/iron/dark,
/area/station/engineering/supermatter/room)
"Jo" = (
/obj/item/clothing/head/utility/welding{
	pixel_x = -3;
	pixel_y = 5
	},
/turf/open/floor/plating,
/area/station/engineering/supermatter/room)
"JY" = (
/obj/machinery/camera/directional/west{
	c_tag = "Engineering Supermatter Fore";
	network = list("ss13","engine")
	},
/obj/machinery/firealarm/directional/west,
/turf/open/floor/plating,
/area/station/engineering/supermatter/room)
"Kt" = (
/obj/structure/reflector/double,
/turf/open/floor/plating,
/area/station/engineering/supermatter/room)
"Lk" = (
/obj/effect/turf_decal/stripes/line{
	dir = 4
	},
/obj/machinery/power/energy_accumulator/tesla_coil,
/obj/machinery/light/floor/has_bulb,
/turf/open/floor/plating,
/area/station/engineering/supermatter)
"Lo" = (
/obj/machinery/atmospherics/pipe/smart/manifold4w/scrubbers/visible,
/turf/open/floor/plating,
/area/station/engineering/supermatter/room)
"Lv" = (
/obj/effect/turf_decal/stripes/line{
	dir = 1
	},
/obj/machinery/light/directional/north,
/obj/machinery/portable_atmospherics/canister/nitrogen,
/obj/machinery/status_display/ai/directional/north,
/turf/open/floor/plating,
/area/station/engineering/supermatter)
"MT" = (
/turf/closed/wall/r_wall,
/area/station/engineering/supermatter/room)
"Np" = (
/obj/machinery/light/directional/north,
/turf/open/floor/plating,
/area/station/engineering/supermatter/room)
"Nu" = (
/obj/item/weldingtool,
/turf/open/floor/plating,
/area/station/engineering/supermatter/room)
"Nv" = (
/obj/item/paper/fluff/ruins/oldstation/protosupermatter,
/turf/open/floor/plating,
/area/station/engineering/supermatter)
"NA" = (
/obj/effect/spawner/structure/window/reinforced/plasma,
/turf/open/floor/plating,
/area/station/engineering/supermatter)
"NN" = (
/obj/machinery/camera/directional/north,
/obj/machinery/status_display/evac/directional/north,
/turf/open/floor/plating,
/area/station/engineering/supermatter/room)
"NS" = (
/obj/effect/turf_decal/stripes/line{
	dir = 4
	},
/obj/effect/turf_decal/trimline/yellow/arrow_ccw{
	dir = 1
	},
/obj/effect/turf_decal/trimline/yellow/arrow_cw,
/turf/open/floor/plating,
/area/station/engineering/supermatter)
"OC" = (
/obj/effect/turf_decal/stripes/line{
	dir = 1
	},
/obj/item/radio/intercom/directional/north,
/turf/open/floor/plating,
/area/station/engineering/supermatter)
"OV" = (
/obj/effect/turf_decal/stripes/line{
	dir = 5
	},
/obj/machinery/light/floor/has_bulb,
/turf/open/floor/plating,
/area/station/engineering/supermatter)
"PF" = (
/obj/machinery/door/firedoor,
/obj/machinery/door/airlock/engineering/glass{
	name = "Supermatter Engine Room"
	},
/obj/effect/mapping_helpers/airlock/access/all/engineering/general,
/obj/machinery/atmospherics/pipe/smart/manifold4w/scrubbers/hidden/layer2,
/turf/open/floor/plating,
/area/station/engineering/supermatter)
"PU" = (
/obj/item/radio/intercom/directional/north,
/turf/open/floor/plating,
/area/station/engineering/supermatter/room)
"PV" = (
/turf/open/floor/plating/airless,
/area/space/nearstation)
"Qn" = (
/turf/closed/wall/r_wall,
/area/station/engineering/supermatter)
"Qq" = (
/obj/effect/turf_decal/stripes/line{
	dir = 8
	},
/obj/structure/sign/delamination_counter/directional/west,
/obj/machinery/camera/directional/west{
	c_tag = "Engineering Supermatter Chamber";
	network = list("engine")
	},
/turf/open/floor/plating,
/area/station/engineering/supermatter)
"QX" = (
/obj/effect/turf_decal/stripes/line{
	dir = 8
	},
/obj/machinery/atmospherics/pipe/smart/manifold4w/scrubbers/hidden/layer2,
/turf/open/floor/plating,
/area/station/engineering/supermatter)
"SS" = (
/turf/open/floor/plating,
/area/station/engineering/supermatter/room)
"Uv" = (
/obj/machinery/power/emitter,
/turf/open/floor/plating,
/area/station/engineering/supermatter/room)
"UI" = (
/obj/effect/turf_decal/stripes/line{
	dir = 1
	},
/obj/machinery/power/energy_accumulator/tesla_coil,
/turf/open/floor/plating,
/area/station/engineering/supermatter)
"Vk" = (
/obj/machinery/door/firedoor,
/obj/structure/cable,
/obj/machinery/door/airlock/engineering/glass{
	name = "Supermatter Engine Room"
	},
/obj/effect/mapping_helpers/airlock/access/all/engineering/general,
/turf/open/floor/plating,
/area/station/engineering/supermatter)
"VC" = (
/obj/effect/turf_decal/stripes/line{
	dir = 6
	},
/obj/machinery/light/floor/has_bulb,
/turf/open/floor/plating,
/area/station/engineering/supermatter)
"Ww" = (
/obj/machinery/light/floor/has_bulb,
/turf/open/floor/plating,
/area/station/engineering/supermatter)
"WU" = (
/obj/structure/closet/firecloset,
/turf/open/floor/plating,
/area/station/engineering/supermatter/room)
"Yf" = (
/obj/effect/turf_decal/stripes/line,
/obj/machinery/status_display/evac/directional/south,
/obj/machinery/camera/directional/south{
	c_tag = "Engineering Supermatter Aft";
	network = list("ss13","engine")
	},
/turf/open/floor/plating,
/area/station/engineering/supermatter)
"Yw" = (
/obj/effect/turf_decal/stripes/line{
	dir = 1
	},
/turf/open/floor/plating,
/area/station/engineering/supermatter)
"Yz" = (
/obj/effect/turf_decal/stripes/line{
	dir = 5
	},
/turf/open/floor/plating,
/area/station/engineering/supermatter)
"YJ" = (
/obj/structure/table/reinforced,
/obj/item/tank/internals/emergency_oxygen/engi,
/obj/item/tank/internals/emergency_oxygen/engi,
/obj/item/clothing/mask/breath{
	pixel_x = 4
	},
/turf/open/floor/plating,
/area/station/engineering/supermatter/room)

(1,1,1) = {"
kK
kK
kK
kK
Qn
NA
PF
NA
Qn
Ib
NA
Vk
NA
wo
Qn
NA
kf
eH
Qn
kK
kK
kK
kK
kK
kK
"}
(2,1,1) = {"
kK
kK
kK
kK
Qn
oJ
QX
qx
Qq
qx
dx
GG
dx
qx
Qq
qx
qx
yW
Qn
kK
kK
kK
kK
kK
kK
"}
(3,1,1) = {"
kK
kK
kK
kK
NA
bY
cT
Bx
cP
cP
cP
NS
cP
cP
HD
Lk
ID
sR
Qn
kK
kK
kK
kK
kK
kK
"}
(4,1,1) = {"
kK
kK
kK
kK
NA
bY
iY
vM
vM
vM
eg
vM
yT
vM
nu
jw
UI
lj
Qn
kK
kK
kK
kK
kK
kK
"}
(5,1,1) = {"
MT
qz
MT
kO
Qn
Lv
iY
vM
vM
Ww
vM
vM
vM
Ww
nu
jw
UI
GH
Qn
kK
kK
kK
kK
kK
kK
"}
(6,1,1) = {"
WU
EU
JY
SS
vM
Yw
BQ
vM
vM
vM
vM
vM
vM
vM
vM
vM
gU
Yf
Qn
kK
kK
kK
kK
kK
kK
"}
(7,1,1) = {"
SS
vY
SS
SS
vM
Yw
iY
vM
vM
vM
vM
yn
Nv
vM
vM
vM
Yw
iY
Qn
kK
kK
kK
kK
kK
kK
"}
(8,1,1) = {"
Np
vY
SS
SS
vM
Yw
BQ
vM
vM
vM
vM
vM
vM
vM
vM
vM
gU
Bc
vM
kK
kK
kK
kK
kK
kK
"}
(9,1,1) = {"
SS
vY
SS
SS
vM
Yw
iY
vM
vM
Ww
vM
vM
vM
Ww
vM
vM
Yw
iY
Qn
kK
kK
kK
kK
kK
kK
"}
(10,1,1) = {"
YJ
np
gQ
SS
vM
Yw
iY
vM
vM
vM
vM
vM
vM
vM
vM
vM
Yw
iY
NA
vI
yt
kK
kK
kK
kK
"}
(11,1,1) = {"
MT
MT
Je
MT
Qn
OC
HO
dx
qx
qx
qx
tg
Bo
qx
qx
dx
CY
iY
NA
kK
yt
vI
yt
tO
kK
"}
(12,1,1) = {"
kK
kK
kK
kK
Qn
Yz
cP
cP
cP
AG
VC
tg
OV
AG
cP
cP
cP
yM
NA
tO
tO
tO
tO
tO
kK
"}
(13,1,1) = {"
kK
kK
kK
kK
MT
SS
SS
SS
SS
SS
SS
SS
SS
SS
SS
SS
SS
af
MT
vI
yt
vI
yt
tO
kK
"}
(14,1,1) = {"
kK
kK
kK
kK
MT
NN
SS
zC
zC
rs
Uv
SS
Uv
SS
Kt
Kt
SS
Dk
MT
vI
yt
vI
yt
tO
kK
"}
(15,1,1) = {"
kK
kK
kK
kK
MT
wm
SS
zC
zC
Jo
Uv
SS
Uv
SS
Kt
Kt
SS
Ay
MT
tO
tO
tO
tO
tO
kK
"}
(16,1,1) = {"
kK
kK
kK
kK
MT
PU
SS
zC
zC
Nu
Uv
SS
Uv
SS
tA
tA
Jc
mO
MT
vI
yt
vI
yt
tO
kK
"}
(17,1,1) = {"
kK
kK
kK
kK
MT
Lo
SS
oW
SS
SS
SS
SS
SS
SS
SS
oW
zi
SS
MT
yt
yt
yt
yt
tO
kK
"}
(18,1,1) = {"
Av
Av
Av
Av
MT
lX
MT
MT
MT
MT
MT
MT
MT
MT
MT
MT
MT
MT
MT
vI
yt
vI
yt
tO
kK
"}
(19,1,1) = {"
kK
kK
kK
Av
Av
tp
kK
kK
Av
kK
kK
kK
kK
PV
kK
kK
kK
kK
Av
tO
tO
tO
tO
tO
kK
"}
(20,1,1) = {"
kK
kK
kK
Av
kK
kK
kK
kK
Av
kK
kK
kK
kK
xe
kK
kK
kK
kK
Av
kK
kK
kK
kK
kK
kK
"}
(21,1,1) = {"
Av
Av
br
br
br
Av
Av
je
br
br
Av
Av
Av
PV
Av
Av
Av
br
br
br
Av
Av
Av
Av
kK
"}
(22,1,1) = {"
kK
kK
kK
kK
Av
kK
kK
Av
kK
Av
kK
kK
kK
PV
kK
kK
kK
Av
kK
kK
kK
kK
kK
kK
kK
"}
(23,1,1) = {"
kK
kK
kK
kK
Av
kK
kK
Av
kK
Av
kK
kK
kK
IH
kK
kK
kK
Av
kK
kK
kK
kK
kK
kK
kK
"}
(24,1,1) = {"
Av
Av
Av
Av
br
br
br
br
Av
br
br
br
Av
PV
Av
br
br
br
Av
br
br
br
br
Av
kK
"}
(25,1,1) = {"
kK
kK
kK
kK
kK
kK
kK
kK
kK
kK
kK
kK
kK
kK
kK
kK
kK
kK
kK
kK
kK
kK
kK
kK
kK
"}
(26,1,1) = {"
kK
kK
kK
kK
kK
kK
kK
kK
kK
kK
kK
kK
kK
kK
kK
kK
kK
kK
kK
kK
kK
kK
kK
kK
kK
"}
(27,1,1) = {"
kK
kK
kK
kK
kK
kK
kK
kK
kK
kK
kK
kK
kK
kK
kK
kK
kK
kK
kK
kK
kK
kK
kK
kK
kK
"}
(28,1,1) = {"
kK
kK
kK
kK
kK
kK
kK
kK
kK
kK
kK
kK
kK
kK
kK
kK
kK
kK
kK
kK
kK
kK
kK
kK
kK
"}
(29,1,1) = {"
kK
kK
kK
kK
kK
kK
kK
kK
kK
kK
kK
kK
kK
kK
kK
kK
kK
kK
kK
kK
kK
kK
kK
kK
kK
"}
(30,1,1) = {"
kK
kK
kK
kK
kK
kK
kK
kK
kK
kK
kK
kK
kK
kK
kK
kK
kK
kK
kK
kK
kK
kK
kK
kK
kK
"}
(31,1,1) = {"
kK
kK
kK
kK
kK
kK
kK
kK
kK
kK
kK
kK
kK
kK
kK
kK
kK
kK
kK
kK
kK
kK
kK
kK
kK
"}
(32,1,1) = {"
kK
kK
kK
kK
kK
kK
kK
kK
kK
kK
kK
kK
kK
kK
kK
kK
kK
kK
kK
kK
kK
kK
kK
kK
kK
"}
(33,1,1) = {"
kK
kK
kK
kK
kK
kK
kK
kK
kK
kK
kK
kK
kK
kK
kK
kK
kK
kK
kK
kK
kK
kK
kK
kK
kK
"}
