//MAP CONVERTED BY dmm2tgm.py THIS HEADER COMMENT PREVENTS RECONVERSION, DO NOT REMOVE
"bG" = (
/obj/structure/cable,
/obj/machinery/power/port_gen/pacman/pre_loaded,
/turf/open/floor/plating,
/area/station/engineering/supermatter)
"dt" = (
/obj/machinery/light/directional/south,
/turf/open/floor/plating,
/area/station/engineering/supermatter/room)
"dB" = (
/obj/effect/turf_decal/stripes/line{
	dir = 4
	},
/obj/machinery/light/floor/has_bulb,
/turf/open/floor/plating,
/area/station/engineering/supermatter)
"ex" = (
/obj/structure/closet/crate/engineering{
	name = "supermatter shard crate"
	},
/obj/machinery/power/supermatter_crystal/shard,
/turf/open/floor/plating,
/area/station/engineering/supermatter)
"fo" = (
/obj/item/weldingtool,
/turf/open/floor/plating,
/area/station/engineering/supermatter/room)
"ft" = (
/turf/closed/wall/r_wall,
/area/station/engineering/supermatter/room)
"ga" = (
/obj/machinery/light/floor/has_bulb,
/turf/open/floor/plating,
/area/station/engineering/supermatter)
"gb" = (
/obj/effect/turf_decal/stripes/line{
	dir = 8
	},
/obj/machinery/power/energy_accumulator/grounding_rod,
/turf/open/floor/plating,
/area/station/engineering/supermatter)
"gv" = (
/obj/item/holosign_creator/atmos,
/turf/open/floor/plating,
/area/station/engineering/supermatter)
"gR" = (
/obj/item/stack/sheet/plasmarglass/fifty{
	pixel_x = -8
	},
/obj/structure/closet/crate/engineering{
	name = "additional materials crate"
	},
/obj/item/stack/sheet/plasteel/fifty{
	pixel_x = 8
	},
/turf/open/floor/plating,
/area/station/engineering/supermatter)
"gV" = (
/obj/effect/turf_decal/stripes/line,
/obj/machinery/light/floor/has_bulb,
/turf/open/floor/plating,
/area/station/engineering/supermatter)
"ha" = (
/obj/effect/turf_decal/stripes/line{
	dir = 4
	},
/obj/item/radio/intercom/directional/east,
/obj/machinery/atmospherics/components/unary/thermomachine/freezer{
	dir = 8
	},
/turf/open/floor/plating,
/area/station/engineering/supermatter)
"ht" = (
/obj/effect/turf_decal/stripes/line{
	dir = 1
	},
/obj/structure/cable,
/obj/effect/turf_decal/trimline/yellow/arrow_ccw{
	dir = 8
	},
/obj/effect/turf_decal/trimline/yellow/arrow_cw{
	dir = 4
	},
/turf/open/floor/plating,
/area/station/engineering/supermatter)
"hL" = (
/obj/structure/cable,
/obj/machinery/power/terminal,
/obj/effect/turf_decal/trimline/yellow/arrow_ccw{
	dir = 8
	},
/obj/effect/turf_decal/trimline/yellow/arrow_cw{
	dir = 4
	},
/turf/open/floor/plating,
/area/station/engineering/supermatter/room)
"io" = (
/obj/structure/reflector/box,
/turf/open/floor/plating,
/area/station/engineering/supermatter/room)
"ix" = (
/obj/effect/turf_decal/stripes/line,
/obj/machinery/light/floor/has_bulb,
/obj/machinery/power/energy_accumulator/grounding_rod,
/turf/open/floor/plating,
/area/station/engineering/supermatter)
"iF" = (
/obj/structure/cable,
/obj/effect/turf_decal/trimline/yellow/arrow_cw{
	dir = 1
	},
/obj/effect/turf_decal/trimline/yellow/arrow_ccw,
/turf/open/floor/plating,
/area/station/engineering/supermatter/room)
"iS" = (
/obj/effect/turf_decal/delivery,
/turf/open/floor/plating,
/area/station/engineering/supermatter)
"iZ" = (
/obj/effect/turf_decal/stripes/corner,
/obj/machinery/power/energy_accumulator/grounding_rod,
/turf/open/floor/plating,
/area/station/engineering/supermatter)
"jr" = (
/obj/effect/turf_decal/stripes/line{
	dir = 4
	},
/obj/machinery/portable_atmospherics/canister/nitrogen,
/turf/open/floor/plating,
/area/station/engineering/supermatter)
"js" = (
/obj/effect/turf_decal/trimline/yellow/arrow_cw{
	dir = 8
	},
/obj/effect/turf_decal/trimline/yellow/arrow_ccw{
	dir = 4
	},
/obj/machinery/light/floor/has_bulb,
/turf/open/floor/plating,
/area/station/engineering/supermatter)
"jI" = (
/obj/effect/turf_decal/stripes/line{
	dir = 1
	},
/obj/machinery/power/energy_accumulator/tesla_coil,
/turf/open/floor/plating,
/area/station/engineering/supermatter)
"kE" = (
/obj/effect/turf_decal/stripes/corner{
	dir = 1
	},
/turf/open/floor/plating,
/area/station/engineering/supermatter)
"kH" = (
/obj/effect/turf_decal/stripes/line{
	dir = 1
	},
/obj/machinery/light/floor/has_bulb,
/turf/open/floor/plating,
/area/station/engineering/supermatter)
"kV" = (
/obj/effect/spawner/structure/window/reinforced/plasma,
/turf/open/floor/plating,
/area/station/engineering/supermatter)
"lv" = (
/obj/effect/turf_decal/stripes/line{
	dir = 4
	},
/obj/machinery/status_display/ai/directional/east,
/turf/open/floor/plating,
/area/station/engineering/supermatter)
"lL" = (
/obj/machinery/camera/emp_proof{
	c_tag = "Engineering - Emitter Room East";
	dir = 6;
	network = list("ss13","engine","engineering")
	},
/obj/machinery/firealarm/directional/east,
/turf/open/floor/plating,
/area/station/engineering/supermatter/room)
"lO" = (
/obj/machinery/door/airlock/engineering/glass{
	name = "Supermatter Engine Room"
	},
/obj/effect/turf_decal/trimline/yellow/filled/line{
	dir = 4
	},
/obj/effect/turf_decal/trimline/yellow/filled/line{
	dir = 8
	},
/obj/machinery/atmospherics/pipe/smart/manifold4w/supply/hidden/layer4,
/obj/machinery/atmospherics/pipe/smart/manifold4w/scrubbers/hidden/layer2,
/obj/machinery/door/firedoor,
/obj/effect/mapping_helpers/airlock/access/all/engineering/general,
/obj/effect/turf_decal/trimline/yellow/arrow_ccw{
	dir = 4
	},
/obj/effect/turf_decal/trimline/yellow/arrow_cw{
	dir = 8
	},
/turf/open/floor/iron,
/area/station/engineering/supermatter)
"mg" = (
/obj/effect/turf_decal/stripes/line{
	dir = 8
	},
/obj/machinery/status_display/evac/directional/west,
/turf/open/floor/plating,
/area/station/engineering/supermatter)
"mH" = (
/obj/effect/turf_decal/stripes/line{
	dir = 1
	},
/obj/structure/cable,
/obj/effect/turf_decal/trimline/yellow/arrow_cw{
	dir = 8
	},
/obj/effect/turf_decal/trimline/yellow/arrow_ccw{
	dir = 4
	},
/turf/open/floor/plating,
/area/station/engineering/supermatter)
"nk" = (
/obj/effect/turf_decal/stripes/line{
	dir = 1
	},
/obj/machinery/atmospherics/pipe/smart/manifold4w/supply/hidden/layer4,
/obj/machinery/atmospherics/pipe/smart/manifold4w/scrubbers/hidden/layer2,
/turf/open/floor/plating,
/area/station/engineering/supermatter)
"nT" = (
/turf/open/floor/plating,
/area/station/engineering/supermatter)
"on" = (
/obj/item/clothing/head/utility/welding{
	pixel_x = -3;
	pixel_y = 5
	},
/turf/open/floor/plating,
/area/station/engineering/supermatter/room)
"oy" = (
/obj/structure/cable,
/turf/closed/wall/r_wall,
/area/station/engineering/supermatter)
"pt" = (
/obj/effect/turf_decal/stripes/line{
	dir = 8
	},
/obj/machinery/camera/emp_proof{
	c_tag = "Engineering - Engine Room Airlock";
	dir = 10;
	network = list("ss13","engine","engineering")
	},
/turf/open/floor/plating,
/area/station/engineering/supermatter)
"pC" = (
/turf/closed/wall,
/area/station/engineering/supermatter)
"pV" = (
/obj/effect/turf_decal/stripes/line{
	dir = 8
	},
/obj/machinery/power/energy_accumulator/tesla_coil,
/turf/open/floor/plating,
/area/station/engineering/supermatter)
"qg" = (
/obj/structure/lattice,
/turf/open/space/basic,
/area/space/nearstation)
"qC" = (
/obj/machinery/status_display/evac/directional/east,
/turf/open/floor/plating,
/area/station/engineering/supermatter/room)
"rA" = (
/obj/effect/turf_decal/stripes/line{
	dir = 6
	},
/turf/open/floor/plating,
/area/station/engineering/supermatter)
"rZ" = (
/obj/machinery/light/small/directional/south,
/obj/effect/turf_decal/sand/plating,
/obj/structure/cable,
/turf/open/floor/plating,
/area/station/engineering/supermatter)
"sm" = (
/obj/effect/baseturf_helper/space,
/turf/open/floor/plating,
/area/station/engineering/supermatter/room)
"st" = (
/obj/structure/reflector/single,
/turf/open/floor/plating,
/area/station/engineering/supermatter/room)
"sz" = (
/obj/effect/turf_decal/stripes/line{
	dir = 8
	},
/obj/machinery/light/floor/has_bulb,
/turf/open/floor/plating,
/area/station/engineering/supermatter)
"sR" = (
/obj/effect/turf_decal/stripes/line{
	dir = 8
	},
/obj/structure/sign/directions/ptl/directional/west,
/obj/machinery/camera/emp_proof{
	c_tag = "Engineering - Engine Room Airlock";
	dir = 10;
	network = list("ss13","engine","engineering")
	},
/turf/open/floor/plating,
/area/station/engineering/supermatter)
"ta" = (
/obj/machinery/door/airlock/external,
/obj/effect/mapping_helpers/airlock/cyclelink_helper{
	dir = 8
	},
/obj/effect/mapping_helpers/airlock/access/all/engineering/general,
/obj/structure/fans/tiny,
/obj/structure/cable,
/turf/open/floor/plating,
/area/station/engineering/supermatter)
"uv" = (
/turf/closed/wall/r_wall,
/area/station/engineering/supermatter)
"uw" = (
/obj/effect/turf_decal/stripes/line{
	dir = 8
	},
/obj/machinery/portable_atmospherics/canister/nitrogen,
/turf/open/floor/plating,
/area/station/engineering/supermatter)
"vH" = (
/obj/structure/table/reinforced,
/obj/item/clothing/head/utility/radiation,
/obj/item/clothing/glasses/meson,
/obj/item/geiger_counter,
/obj/item/geiger_counter,
/obj/effect/turf_decal/stripes/line{
	dir = 1
	},
/turf/open/floor/plating,
/area/station/engineering/supermatter)
"wR" = (
/obj/effect/turf_decal/stripes/line{
	dir = 5
	},
/turf/open/floor/plating,
/area/station/engineering/supermatter)
"wW" = (
/obj/item/wrench,
/turf/open/floor/plating,
/area/station/engineering/supermatter/room)
"yM" = (
/obj/effect/turf_decal/stripes/line{
	dir = 1
	},
/obj/structure/cable,
/obj/machinery/power/apc/auto_name/directional/north{
	areastring = "/area/station/engineering/supermatter"
	},
/turf/open/floor/plating,
/area/station/engineering/supermatter)
"Al" = (
/obj/effect/turf_decal/stripes/line,
/turf/open/floor/plating,
/area/station/engineering/supermatter)
"Br" = (
/obj/effect/turf_decal/stripes/line{
	dir = 8
	},
/turf/open/floor/plating,
/area/station/engineering/supermatter)
"BB" = (
/obj/effect/turf_decal/stripes/line,
/obj/machinery/camera/emp_proof/directional/south{
	c_tag = "Engineering - Engine Room South-East";
	network = list("ss13","engine","engineering")
	},
/turf/open/floor/plating,
/area/station/engineering/supermatter)
"BF" = (
/obj/effect/turf_decal/stripes/line{
	dir = 4
	},
/obj/machinery/portable_atmospherics/canister/nitrogen,
/obj/machinery/camera/emp_proof{
	c_tag = "Engineering - Engine Room Airlock";
	dir = 6;
	network = list("ss13","engine","engineering")
	},
/turf/open/floor/plating,
/area/station/engineering/supermatter)
"Dh" = (
/turf/open/floor/plating,
/area/station/engineering/supermatter/room)
"Dk" = (
/obj/effect/turf_decal/stripes/line{
	dir = 8
	},
/obj/structure/sign/warning/vacuum/external/directional/west,
/turf/open/floor/plating,
/area/station/engineering/supermatter)
"Dq" = (
/obj/effect/turf_decal/stripes/line{
	dir = 10
	},
/turf/open/floor/plating,
/area/station/engineering/supermatter)
"Ep" = (
/obj/item/paper/fluff/ruins/oldstation/protosupermatter,
/turf/open/floor/plating,
/area/station/engineering/supermatter)
"Ex" = (
/obj/structure/cable,
/obj/machinery/status_display/ai/directional/west,
/obj/effect/turf_decal/trimline/yellow/arrow_ccw{
	dir = 8
	},
/obj/effect/turf_decal/trimline/yellow/arrow_cw{
	dir = 4
	},
/turf/open/floor/plating,
/area/station/engineering/supermatter/room)
"EY" = (
/obj/structure/reflector/double,
/turf/open/floor/plating,
/area/station/engineering/supermatter/room)
"FF" = (
/obj/effect/turf_decal/stripes/line{
	dir = 8
	},
/obj/structure/cable,
/obj/effect/turf_decal/trimline/yellow/arrow_cw,
/obj/effect/turf_decal/trimline/yellow/arrow_ccw{
	dir = 1
	},
/turf/open/floor/plating,
/area/station/engineering/supermatter)
"FQ" = (
/obj/machinery/airalarm/directional/west,
/obj/machinery/power/smes/engineering,
/obj/structure/cable,
/turf/open/floor/plating,
/area/station/engineering/supermatter/room)
"JT" = (
/obj/effect/turf_decal/stripes/corner{
	dir = 8
	},
/turf/open/floor/plating,
/area/station/engineering/supermatter)
"Kh" = (
/obj/effect/turf_decal/stripes/line{
	dir = 1
	},
/turf/open/floor/plating,
/area/station/engineering/supermatter)
"Kv" = (
/obj/machinery/door/airlock/external,
/obj/effect/mapping_helpers/airlock/cyclelink_helper{
	dir = 4
	},
/obj/effect/mapping_helpers/airlock/access/all/engineering/general,
/obj/effect/turf_decal/sand/plating,
/obj/structure/cable,
/turf/open/floor/plating,
/area/station/engineering/supermatter)
"Kx" = (
/obj/structure/table/reinforced,
/obj/item/tank/internals/emergency_oxygen/engi{
	pixel_x = 5
	},
/obj/item/clothing/gloves/color/black,
/obj/item/clothing/glasses/meson/engine,
/obj/effect/turf_decal/stripes/line{
	dir = 1
	},
/turf/open/floor/plating,
/area/station/engineering/supermatter)
"Ln" = (
/turf/template_noop,
/area/template_noop)
"Nc" = (
/obj/effect/turf_decal/stripes/line{
	dir = 1
	},
/obj/structure/sign/delamination_counter/directional/north,
/turf/open/floor/plating,
/area/station/engineering/supermatter)
"Ov" = (
/obj/effect/turf_decal/stripes/line,
/obj/machinery/camera/emp_proof/directional/south{
	c_tag = "Engineering - Engine Room South-West";
	network = list("ss13","engine","engineering")
	},
/turf/open/floor/plating,
/area/station/engineering/supermatter)
"PE" = (
/obj/effect/turf_decal/stripes/line{
	dir = 4
	},
/obj/machinery/atmospherics/components/unary/thermomachine/freezer{
	dir = 8
	},
/turf/open/floor/plating,
/area/station/engineering/supermatter)
"PF" = (
/obj/machinery/atmospherics/pipe/smart/manifold4w/orange/visible,
/obj/structure/cable,
/obj/machinery/meter,
/turf/closed/wall/r_wall,
/area/station/engineering/supermatter)
"Rq" = (
/obj/machinery/power/energy_accumulator/tesla_coil,
/turf/open/floor/plating,
/area/station/engineering/supermatter)
"RS" = (
/obj/effect/turf_decal/stripes/line{
	dir = 9
	},
/obj/machinery/power/energy_accumulator/tesla_coil,
/turf/open/floor/plating,
/area/station/engineering/supermatter)
"SM" = (
/obj/machinery/atmospherics/pipe/smart/manifold4w/scrubbers/visible,
/obj/machinery/meter,
/turf/closed/wall/r_wall,
/area/station/engineering/supermatter)
"Ta" = (
/obj/effect/turf_decal/stripes/line{
	dir = 6
	},
/obj/machinery/atmospherics/pipe/smart/manifold4w/scrubbers/visible,
/turf/open/floor/plating,
/area/station/engineering/supermatter)
"Tn" = (
/obj/structure/table/reinforced,
/obj/item/clothing/head/utility/radiation,
/obj/item/clothing/glasses/meson,
/obj/item/clothing/glasses/meson,
/obj/effect/turf_decal/stripes/line{
	dir = 1
	},
/obj/machinery/firealarm/directional/north,
/turf/open/floor/plating,
/area/station/engineering/supermatter)
"UX" = (
/obj/effect/turf_decal/stripes/corner{
	dir = 4
	},
/turf/open/floor/plating,
/area/station/engineering/supermatter)
"Vm" = (
/obj/effect/turf_decal/stripes/line{
	dir = 5
	},
/obj/machinery/airalarm/engine{
	dir = 1;
	pixel_y = 23
	},
/turf/open/floor/plating,
/area/station/engineering/supermatter)
"VB" = (
/obj/machinery/power/emitter,
/turf/open/floor/plating,
/area/station/engineering/supermatter/room)
"VP" = (
/obj/effect/turf_decal/stripes/line{
	dir = 4
	},
/turf/open/floor/plating,
/area/station/engineering/supermatter)
"Wf" = (
/obj/effect/turf_decal/trimline/yellow/arrow_ccw{
	dir = 8
	},
/obj/effect/turf_decal/trimline/yellow/arrow_cw{
	dir = 4
	},
/obj/machinery/light/floor/has_bulb,
/turf/open/floor/plating,
/area/station/engineering/supermatter)
"Wn" = (
/obj/effect/spawner/structure/window/reinforced,
/obj/structure/cable,
/turf/open/floor/plating,
/area/station/engineering/supermatter)
"XW" = (
/obj/effect/turf_decal/stripes/line{
	dir = 1
	},
/obj/structure/sign/delamination_counter/directional/north,
/obj/machinery/power/energy_accumulator/tesla_coil,
/turf/open/floor/plating,
/area/station/engineering/supermatter)
"YA" = (
/obj/machinery/atmospherics/components/binary/pump{
	dir = 8;
	name = "Atmos to Loop"
	},
/obj/effect/turf_decal/stripes/line{
	dir = 4
	},
/turf/open/floor/plating,
/area/station/engineering/supermatter)
"YM" = (
/obj/effect/turf_decal/stripes/line{
	dir = 4
	},
/obj/machinery/camera/emp_proof{
	c_tag = "Engineering - Engine Room Airlock";
	dir = 6;
	network = list("ss13","engine","engineering")
	},
/obj/machinery/atmospherics/components/unary/thermomachine/freezer{
	dir = 8
	},
/turf/open/floor/plating,
/area/station/engineering/supermatter)
"Zt" = (
/obj/structure/table/reinforced,
/obj/item/storage/toolbox/mechanical,
/obj/effect/turf_decal/stripes/line{
	dir = 1
	},
/obj/item/pipe_dispenser,
/turf/open/floor/plating,
/area/station/engineering/supermatter)
"ZA" = (
/obj/effect/turf_decal/stripes/line{
	dir = 9
	},
/turf/open/floor/plating,
/area/station/engineering/supermatter)
"ZI" = (
/obj/machinery/camera/emp_proof{
	c_tag = "Engineering - Emitter Room West";
	dir = 10;
	network = list("ss13","engine","engineering")
	},
/obj/structure/cable,
/obj/machinery/power/apc/auto_name/directional/west,
/obj/effect/turf_decal/trimline/yellow/arrow_ccw{
	dir = 10
	},
/obj/effect/turf_decal/trimline/yellow/corner{
	dir = 4
	},
/turf/open/floor/plating,
/area/station/engineering/supermatter/room)

(1,1,1) = {"
Ln
Ln
Ln
Ln
Ln
Ln
Ln
Ln
Ln
Ln
qg
qg
qg
Ln
Ln
Ln
Ln
Ln
Ln
Ln
"}
(2,1,1) = {"
Ln
Ln
Ln
Ln
Ln
Ln
Ln
qg
qg
qg
qg
qg
qg
qg
qg
qg
Ln
Ln
Ln
Ln
"}
(3,1,1) = {"
Ln
Ln
Ln
Ln
Ln
Ln
Ln
qg
qg
qg
qg
qg
qg
qg
qg
qg
Ln
Ln
Ln
Ln
"}
(4,1,1) = {"
Ln
Ln
Ln
Ln
Ln
Ln
Ln
qg
qg
qg
qg
qg
qg
qg
qg
qg
Ln
Ln
Ln
Ln
"}
(5,1,1) = {"
Ln
Ln
Ln
Ln
Ln
Ln
Ln
qg
qg
qg
qg
qg
qg
qg
qg
qg
qg
Ln
Ln
Ln
"}
(6,1,1) = {"
Ln
Ln
Ln
Ln
Ln
Ln
qg
qg
qg
qg
qg
qg
qg
qg
qg
qg
qg
Ln
Ln
Ln
"}
(7,1,1) = {"
Ln
Ln
Ln
Ln
Ln
Ln
qg
qg
qg
qg
qg
qg
qg
qg
qg
qg
qg
Ln
Ln
Ln
"}
(8,1,1) = {"
Ln
Ln
Ln
Ln
Ln
Kv
pC
qg
qg
qg
qg
qg
qg
qg
qg
qg
qg
Ln
Ln
Ln
"}
(9,1,1) = {"
Ln
Ln
Ln
Ln
pC
rZ
pC
qg
qg
qg
qg
qg
qg
qg
qg
qg
qg
Ln
Ln
Ln
"}
(10,1,1) = {"
uv
uv
uv
uv
uv
ta
uv
uv
kV
kV
uv
uv
uv
uv
ft
ft
ft
ft
ft
ft
"}
(11,1,1) = {"
uv
RS
pV
gb
sR
FF
Dk
mg
Br
Br
Br
pt
Br
Dq
Ex
hL
FQ
ZI
Dh
ft
"}
(12,1,1) = {"
uv
jI
Rq
iZ
VP
VP
dB
VP
dB
VP
VP
UX
nT
Ov
Dh
Dh
Dh
iF
Dh
ft
"}
(13,1,1) = {"
uv
XW
Rq
ix
nT
nT
nT
nT
nT
nT
nT
kH
nT
Al
Dh
EY
EY
io
dt
ft
"}
(14,1,1) = {"
uv
Zt
nT
Al
nT
nT
nT
nT
nT
nT
nT
Kh
nT
Al
Dh
EY
EY
io
Dh
ft
"}
(15,1,1) = {"
uv
Kx
nT
Al
nT
ga
nT
nT
nT
ga
nT
Kh
nT
Al
Dh
wW
on
fo
Dh
ft
"}
(16,1,1) = {"
Wn
mH
js
Al
gR
nT
nT
Ep
nT
nT
nT
wR
dB
rA
Dh
VB
VB
VB
Dh
ft
"}
(17,1,1) = {"
lO
nk
nT
Al
nT
nT
nT
ex
nT
nT
nT
iS
iS
iS
sm
Dh
Dh
Dh
Dh
ft
"}
(18,1,1) = {"
Wn
ht
Wf
Al
gv
nT
nT
nT
nT
nT
nT
ZA
sz
Dq
Dh
VB
VB
VB
Dh
ft
"}
(19,1,1) = {"
uv
vH
nT
Al
nT
ga
nT
nT
nT
ga
nT
Kh
nT
Al
Dh
Dh
Dh
Dh
Dh
ft
"}
(20,1,1) = {"
uv
Tn
nT
Al
nT
nT
nT
nT
nT
nT
nT
Kh
nT
Al
Dh
st
st
st
Dh
ft
"}
(21,1,1) = {"
uv
Nc
nT
gV
nT
nT
nT
nT
nT
nT
nT
kH
nT
Al
Dh
st
st
st
dt
ft
"}
(22,1,1) = {"
uv
yM
bG
JT
uw
uw
sz
Br
sz
Br
Br
kE
nT
BB
Dh
Dh
Dh
Dh
Dh
ft
"}
(23,1,1) = {"
uv
Vm
VP
YA
BF
jr
VP
lv
VP
PE
ha
YM
VP
Ta
qC
Dh
Dh
lL
Dh
ft
"}
(24,1,1) = {"
uv
oy
oy
PF
oy
oy
oy
oy
oy
oy
oy
oy
uv
SM
ft
ft
ft
ft
ft
ft
"}
