//MAP CONVERTED BY dmm2tgm.py THIS HEADER COMMENT PREVENTS RECONVERSION, DO NOT REMOVE
"a" = (
/turf/closed/wall/mineral/titanium,
/area/space)
"b" = (
/obj/structure/chair/comfy/shuttle{
	dir = 4
	},
/turf/open/floor/mineral/titanium,
/area/space)
"c" = (
/turf/open/space/basic,
/area/space)
"d" = (
/obj/structure/chair/comfy/shuttle{
	dir = 4
	},
/obj/machinery/requests_console/directional/north{
	department = "Arrival shuttle"
	},
/turf/open/floor/mineral/titanium,
/area/space)
"f" = (
/obj/structure/window/reinforced/spawner/directional/east,
/turf/open/floor/plating/airless,
/area/space)
"g" = (
/obj/structure/table,
/turf/open/floor/mineral/titanium/blue,
/area/space)
"i" = (
/obj/structure/chair/comfy/shuttle{
	dir = 4
	},
/obj/machinery/light/directional/north,
/turf/open/floor/mineral/titanium,
/area/space)
"l" = (
/obj/machinery/light/directional/north,
/turf/open/floor/mineral/titanium/blue,
/area/space)
"q" = (
/obj/machinery/modular_computer/console/preset/cargochat{
	dir = 8
	},
/turf/open/floor/mineral/titanium/blue,
/area/space)
"r" = (
/obj/structure/table,
/obj/item/storage/medkit/regular,
/obj/machinery/light/directional/north,
/turf/open/floor/mineral/titanium,
/area/space)
"s" = (
/obj/docking_port/mobile/arrivals{
	dir = 4
	},
/turf/closed/wall/mineral/titanium,
/area/space)
"t" = (
/obj/machinery/light/directional/south,
/turf/open/floor/mineral/titanium/blue,
/area/space)
"w" = (
/obj/structure/closet/wardrobe/black,
/turf/open/floor/mineral/titanium/blue,
/area/space)
"x" = (
/obj/machinery/computer/atmos_alert{
	dir = 8
	},
/turf/open/floor/mineral/titanium/blue,
/area/space)
"y" = (
/turf/open/floor/mineral/titanium,
/area/space)
"A" = (
/obj/effect/spawner/structure/window/reinforced/shuttle,
/turf/open/floor/plating/airless,
/area/space)
"B" = (
/obj/machinery/door/airlock/titanium{
	name = "Arrivals Shuttle Airlock"
	},
/obj/structure/fans/tiny,
/turf/open/floor/plating,
/area/space)
"C" = (
/obj/structure/chair/comfy/shuttle{
	dir = 4
	},
/turf/open/floor/mineral/titanium/blue,
/area/space)
"G" = (
/obj/structure/chair/comfy/shuttle{
	dir = 8
	},
/obj/machinery/light/directional/south,
/turf/open/floor/mineral/titanium,
/area/space)
"J" = (
/obj/structure/closet/wardrobe/green,
/obj/machinery/light/directional/south,
/turf/open/floor/mineral/titanium/blue,
/area/space)
"K" = (
/obj/machinery/door/airlock/titanium{
	name = "Arrivals Shuttle Airlock"
	},
/turf/open/floor/mineral/titanium/blue,
/area/space)
"L" = (
/obj/effect/spawner/structure/window/reinforced/shuttle,
/turf/open/floor/plating,
/area/space)
"M" = (
/obj/structure/table,
/turf/open/floor/mineral/titanium,
/area/space)
"N" = (
/turf/open/floor/mineral/titanium/blue,
/area/space)
"P" = (
/turf/open/floor/plating/airless,
/area/space)
"R" = (
/obj/machinery/power/shuttle_engine/large{
	dir = 8
	},
/turf/open/floor/plating/airless,
/area/space)
"S" = (
/obj/structure/closet/emcloset,
/obj/machinery/light/directional/south,
/turf/open/floor/mineral/titanium/blue,
/area/space)
"T" = (
/obj/structure/chair/comfy/shuttle{
	dir = 8
	},
/turf/open/floor/mineral/titanium,
/area/space)
"V" = (
/obj/structure/chair/comfy/shuttle{
	dir = 8
	},
/obj/machinery/light/directional/north,
/turf/open/floor/mineral/titanium,
/area/space)
"W" = (
/obj/structure/closet/emcloset,
/turf/open/floor/mineral/titanium/blue,
/area/space)
"X" = (
/obj/structure/chair/comfy/shuttle{
	dir = 4
	},
/obj/machinery/light/directional/south,
/turf/open/floor/mineral/titanium,
/area/space)

(1,1,1) = {"
a
P
R
s
P
R
a
"}
(2,1,1) = {"
a
f
f
a
f
f
a
"}
(3,1,1) = {"
L
b
b
N
b
b
L
"}
(4,1,1) = {"
a
i
b
N
b
X
a
"}
(5,1,1) = {"
L
b
b
N
b
b
L
"}
(6,1,1) = {"
a
i
b
N
b
X
a
"}
(7,1,1) = {"
L
b
b
N
b
b
L
"}
(8,1,1) = {"
a
a
a
N
a
a
a
"}
(9,1,1) = {"
a
i
b
N
b
X
a
"}
(10,1,1) = {"
L
y
y
N
y
y
L
"}
(11,1,1) = {"
a
V
T
N
T
G
a
"}
(12,1,1) = {"
a
a
a
N
a
a
a
"}
(13,1,1) = {"
a
d
b
N
N
J
a
"}
(14,1,1) = {"
B
N
N
N
N
w
a
"}
(15,1,1) = {"
B
N
N
N
N
W
a
"}
(16,1,1) = {"
a
r
M
N
N
S
a
"}
(17,1,1) = {"
a
a
a
K
a
a
a
"}
(18,1,1) = {"
a
N
N
N
N
N
a
"}
(19,1,1) = {"
a
l
C
g
C
t
a
"}
(20,1,1) = {"
a
a
q
g
x
a
a
"}
(21,1,1) = {"
c
a
A
A
A
a
c
"}
